Aabhaa	आभा
Aabheer	आभीर
Aabhijaat	आभिजात
Aabid	आबिद
Aachaaryanandan	आचार्यनंदन
Aachaaryanandana	आचार्यनंदना
Aachaarynandanaa	आचार्यनंदना
Aachaarysut	आचार्यसुत
Aacharyasut	आचार्यसुत
Aacharyasuta	आचार्यसुता
Aacharynandan	आचार्यनंदन
Aacharysut	आचार्यसुत
Aachrya	आचार्य
Aada	आडा
Aadamkhor	आदमखोर
Aadesh	आदेश
Aadharshila	आधारशिला
Aadhunik	आधुनिक
Aadilakshman	आदिलक्ष्मण
Aadinaarayan	आदिनारायण
Aadinath	आदिनाथ
Aadishankar	आदिशंकर
Aadishree	आदिश्री
Aadishvar	आदिश्वर
Aadityavardhan	आदित्यवर्धन
Aaditynandan	आदित्यनंदन
Aafat	आफत
Aag	आग
Aage	आगे
Aahat	आहट
Aahi	आही
Aahlaad	आह्लाद
Aahuti	आहुती
Aaina	आईना
Aaj	आज
Aaja	आजा
Aajaad	आजाद
Aajinky	आजिंक्य
Aakaasha	आकाश
Aakhri	आखरी
Aakrant	आक्रांत
Aakrosh	आक्रोश
Aalaap	आलाप
Aalam	आलम
Aalap	आलाप
Aalha	आल्हा
Aalhad	आल्हाद
Aalimah	आलिमाह
Aaliyah	आलियाह
Aalok	आलोक
Aamer	आमेर
Aamod	आमोद
Aanandamayi	आनंदमयी
Aanandini	आनंदिनी
Aanandit	आनंदित
Aanchal	आंचल
Aandhi	आंधी
Aandhiyan	आंधिया
Aane	आने
Aangan	आंगन
Aankh	आँख
Aansoo	आसू
Aapas	आपस
Aaqilah	आकिलाह
Aarambh	आरंभ
Aarif	आरिफ
Aarohan	आरोहण
Aas	आस
Aasan	आसान
Aashaa	आशा
Aashik	आशिक
Aashiq	आशिक
Aashutosh	आशुतोष
Aasif	आसीफ
Aasiyah	आसियाह
Aasmaan	आसमान
Aastha	आस्था
Aathalekar	आठलेकर
Aatif	आतीफ
Aatiqah	आतिकाह
Aatmajaa	आत्मजा
Aaya	आया
Aaye	आये
Aayega	आएगा
Aayi	आई
Aayushman	आयुष्मान
Aayushmati	आयुष्मती
Aazmaish	आजमाइश
Abanoor	अबनूर
Abasah	अबसाह
Abbaas	अब्बास
Abbas	अब्बास
Abbasi	अब्बासी
Abbott	एबॉट
Abdah	अब्दाह
Abdnaan	अब्दनान
Abdul	अब्दुल
Abeedah	अबीदाह
Abeera	अबीरा
Aber	एबर
Abertay	एबरटे
Abha	आभा
Abhayaprad	अभयप्रद
Abheer	अभीर
Abheeru	अभीरु
Abhibhaav	अभिभाव
Abhidi	अभिदि
Abhijaatya	अभिजात्य
Abhijatya	अभिजात्य
Abhijeet	अभिजीत
Abhijit	अभिजीत
Abhijvaalaa	अभिज्वाला
Abhijvalaa	अभिज्वाला
Abhijwaala	अभिज्वाला
Abhijwala	अभिज्वाला
Abhijwalaa	अभिज्वाला
Abhilaash	अभिलाष
Abhilashaa	अभिलाषा
Abhim	अबहीम
Abhimaan	अभिमान
Abhiman	अभिमान
Abhimand	अभिमन्द
Abhimanyusut	अभिमन्युसुत
Abhimoda	अभिमोद
Abhinaath	अभिनाथ
Abhinabhaas	अभिनभास
Abhinabhas	अभिनभास
Abhinandan	अभिनन्दन
Abhinav	अभिनव
Abhinetri	अभिनेत्री
Abhir	अभीर
Abhiraam	अभिराम
Abhishek	अभिषेक
Abhishok	अभिशोक
Abhisok	अभिशोक
Abhisoka	अभिसोक
Abhiveer	अभिवीर
Abhyagni	अभ्यग्नि
Abhyuday	अभ्युदय
Abhyudita	अभ्युदिता
Abhyuditaa	अभ्युदिता
Abigail	अबेगेल
Abington	एबिंग्टन
Abjayoni	अब्जयोनि
Abjit	अब्जित
Abqurah	अबकुराह
Abrad	अबराद
Abraham	अब्राहम
Abrash	अबराश
Abrolhos	एब्रोल्होस
Absaroka	अब्सारोका
Abu	अबू
Abyssinia	एबीसीनिया
Abzug	एब्जुग
Acacia	एकेसिया
Acaryatanaya	अकर्यतनया
Accalia	एक्कालिया
Achaarynandan	आचार्यनंदन
Achaarynandana	आचार्यनंदना
Achaarynandanaa	आचार्यनंदना
Achal	अचल
Achala	अचला
Achalaa	अचला
Achalapati	अचलापति
Achaleshvara	अचलेश्वर
Achalesvara	अचलेश्वर
Achaleswar	अचलेश्वर
Achaleswara	अचलेश्वर
Achalpur	अचलपुर
Acharyanandanaa	आचार्यनंदना
Acharyasut	आचार्यसुत
Acharynandan	आचार्यनंदन
Acharynandanaa	आचार्यनंदना
Acharysutaa	आचार्यसुता
Achhnera	अछनेरा
Achievement	अचीवमेंट
Achille	अचीले
Achindr	अचिंद्र
Achindra	अचिंद्र
Achra	अचरा
Achyut	अच्युत
Achyuta	अच्युत
Achyutaraay	अच्युतराय
Activity	एक्टीविटी
Actress	एक्ट्रेस
Ad	एड
Ada	अदा
Adalat	अदालत
Adani	आडनी
Adarsh	आदर्श
Adarsha	आदर्श
Adarshi	आदर्शी
Addan	अड्डण
Addis	आदिस
Addison	एडिसन
Adecco	एडेक्को
Adelle	एडेल
Adesar	आदेसर
Adesh	आदेश
Adharm	अधर्म
Adhikari	अधिकारी
Adie	एडी
Adil	अदिल
Adil	आदिल
Adimurti	आदिमूर्ति
Adinaaraayan	आदिनारायण
Adinaraayan	आदिनारायण
Adinarayan	आदिनारायण
Adishvar	आदिश्वर
Adityanandan	आदित्यनंदन
Adityvardhan	आदित्यवर्धन
Admiralty	एडमिरैल्टी
Adnan	अदनान
Adolf	अडॉल्फ
Adolfo	एडोल्फो
Adoni	अदोनी
Adrian	एड्रियन
Adrian	एड्रिअन
Adriatic	एड्रीएटिक
Adrina	एड्रिना
Aduz	अदुज़
Advaaki	अद्वाकी
Advaki	अद्वाकी
Advent	एडवेन्ट
Adway	अद्वय
Aegon	एगॉन
Aelwen	एल्वेन
Aeterna	एटर्न
Afadal	अफदल
Afaf	अफाफ
Afafura	अफाफुरा
Afasaana	अफसाना
Afasara	अफसरा
Afdal	अफदल
Afeef	अफीफ
Afghani	अफगानी
Afghanistan	अफगानिस्तान
Afifah	अफिफाह
Afjal	अफजल
Aflatoon	अफलातून
Afra	अफ्रा
Africa	आफ्रिका
African	अफ्रिकन
African	अफ्रीकन
Afridi	अफरीदी
Afsana	अफसाना
Afsane	अफसाने
After	आफ्टर
Agaalia	अगालिया
Agalia	अगालिया
Agape	अगापे
Agar	अगर
Agas	अगास
Agasod	अगासोद
Agaton	एगाटन
Age	आगे
Age	ऐज
Aghwanpur	अघ्वानपुर
Agincourt	अजिनकोर्ट
Aglaia	एग्लेइया
Agney	आग्नेय
Agnija	अग्निजा
Agnikumaar	अग्निकुमार
Agra	आग्रा
Agradoot	अग्रदूत
Agrawal	अग्रवाल
Agreement	एग्रीमेंट
Agricole	एग्रीकोल
Agricultural	एग्रिकल्चरल
Agricultural	एग्रीकल्चरल
Agriculture	एग्रिकल्चर
Agrima	अग्रिमा
Agritech	एग्रीटेक
Agroia	अगरोइया
Ahaggar	अहाग्गर
Ahalya	अहल्या
Ahankaar	अहंकार
Ahilya	अहिल्या
Ahindra	अहिंद्र
Ahraura	अहरौरा
Ahuja	अहूजा
Ahwaanit	आह्वानित
Ahwas	अहवास
Aideen	ऐदीन
Aidh	ऐध
Aighar	ऐगर
Aikya	ऐक्य
Ailis	ऐलिस
Ain	ऐन
Aine	ऐनी
Aircon	एयरकॉन
Aire	आइरे
Aires	आयर्स
Airlines	एयरलाइंस
Airmans	एयरमन्स
Airways	एयरवेज
Aisa	ऐसा
Aise	ऐसे
Aishwarya	ऐश्वर्या
Aisi	ऐसी
Aisling	ऐस्लिंग
Ait	ऐट
Aitana	ऐतना
Aithal	ऐथल
Aiye	आइए
Ajaatshatru	अजातशत्रु
Ajanta	अजंता
Ajantaa	अजंता
Ajaradaah	अजरदाह
Ajaraka	अजार्का
Ajax	अजैक्स
Ajay	अजय
Ajeebaah	अजीबाह
Ajendr	अजेंद्र
Ajendra	अजेंद्र
Aji	अजी
Ajinkya	अजिंक्य
Ajit	अजित
Ajitaabh	अजिताभ
Ajitabh	अजिताभ
Ajmani	अजमानी
Ajmer	अजमेर
Ajnabi	अजनबी
Ajusco	एजुस्को
Ajwaad	अजवाद
Akaankshaa	आकांक्षा
Akaar	आकार
Akabar	अकबर
Akademi	अकेडमी
Akagi	अकागी
Akanapet	अकानपेट
Akanksha	आकांक्षा
Akhir	आखीर
Akhlaq	अखलाक
Akhtar	अख्तर
Akhtar	खान
Akhtiyar	अख्तियार
Akila	अकीला
Akitsu	अकिट्सू
Aklia	अकलिया
Akola	अकोला
Akolner	अकोल्नर
Akora	अकोरा
Akosombo	एकोसोम्बो
Akram	अकरम
Akshar	अक्षर
Akshat	अक्षत
Akshaya	अक्षया
Akshitaa	अक्षिता
Akul	अकुल
Akutagawa	अकुटागावा
Ala	अला
Alabama	एलबामा
Alabanza	अलबन्जा
Alaina	एलैना
Alair	अलैर
Alaka	अलका
Alakananda	अलकनंदा
Alam	आलम
Alamatti	अलामट्टी
Alamo	अलैमो
Alan	अलान
Alan	एलन
Alan	ऐलन
Alana	अलना
Alannis	एलान्निस
Alap	आलाप
Alaska	अलास्का
Alastair	अलस्टेयर
Alastair	अलस्टेर
Alayna	एलायना
Alba	अल्बा
Albatross	अल्बाट्रोस
Albemarle	एल्बेमारले
Albert	अल्बर्ट
Albie	अल्बी
Albina	अल्बिना
Albion	अल्बियोन
Albukerk	अलबुकर्क
Albury	एल्बरी
Alcatel	एल्केटल
Alda	एल्दा
Aldin	अलदीन
Aldous	अल्डुअस
Aleda	एलेडा
Aleema	अलीमा
Aleemah	अलीमाह
Aler	अलेर
Alexa	अलेक्सा
Alexander	अलेक्जेंडर
Alexander	अलेक्झेंडर
Alexander	एलेक्जेंडर
Alexandre	अलेक्जैंडर
Alexandros	एलेक्जैंड्रस
Alfonso	अल्फोन्सो
Alfred	अल्फ्रेड
Alfred	एल्फ्रेड
Alger	अल्गर
Algeria	अल्जेरिया
Algernon	अल्गेर्नोन
Alia	अलिया
Alicante	एलीकेन्ट
Alice	एलिस
Aligarh	अलीगड
Alison	एलीसन
Alistair	एलिस्टैर
Aliwal	अलीवाल
Aliyar	अलियार
Alka	अलका
Alka	अल्का
Alladin	अलादीन
Allah	अल्लाह
Allan	एलन
Allan	ऐलन
Allauddin	अलाउद्दीन
Allayna	अलायना
Allegheny	अल्लेगहेन्ये
Allen	एलन
Allen	एलेन
Allen	ऐलन
Allendale	ऐलेंडेल
Allene	एलेन
Allepi	अल्लेपी
Alleppey	एलेप्पे
Alleyne	एलेन
Alliance	अलाएंस
Alliance	अलायंस
Allianz	एलायंज
Allstate	ऑलस्टेट
Allyson	एलीसन
Almatti	अल्माती
Almonda	अलमोंडा
Alnavar	अल्नावर
Alok	आलोक
Aloudpuri	अलौदपुरी
Alpanaa	अल्पना
Alphonse	अल्फोंसे
Alpine	एल्पाइन
Alsatia	एल्सेटिया
Altair	अल्तायर
Altamaha	अल्तमाहा
Alternate	अल्टरनेट
Althea	एल्थिया
Aluabari	अलुआबरी
Alvarion	अल्वेरियन
Alwis	एल्विस
Alyn	एलिन
Am	एम
Amaanaath	अमानाथ
Amaanat	अमानत
Amaanath	अमानाथ
Amaanda	अमांडा
Amadeo	अमाडियो
Amadis	एमेडिस
Amador	एमाडोर
Amadou	अमादोउ
Amagi	अमागी
Amah	अमाह
Amal	अमल
Amalataas	अमलतास
Amalatas	अमलतास
Amalean	अमालीन
Amalendu	अमलेंदु
Amalesh	अमलेश
Amalner	अमलनेर
Amaltas	अमलतास
Amanjit	अमनजीत
Amara	अमरा
Amarap	अमरप
Amararaaj	अमरराज
Amarashri	अमराश्री
Amaravathi	अमरावती
Amareesh	अमरीश
Amareshwar	अमरेश्वर
Amarik	अमरीक
Amarkaant	अमरकांत
Amarpura	अमरपुर
Amartya	अमर्त्य
Amazing	अमेजिंग
Ambala	अंबाला
Ambarish	अंबरीश
Ambasamudram	अम्बासमुद्रम
Ambekar	आंबेकर
Amber	अम्बेर
Ambliyasan	अम्बलियासन
Ambreesh	अंबरीश
Ambrim	अम्बरिम
Ambrose	एम्ब्रोज
Ambuja	अंबुजा
Ambujaa	अंबुजा
Ambup	अम्बुप
Amburaj	अंबुराज
Ameen	अमीन
Ameena	अमीना
Ameeri	अमीरी
Amelia	एमेलिया
Amelie	अमेली
Amenities	अमेनिटीस
Amer	अमेर
Amerada	एमरेडा
Amergin	अमेर्जिन
America	अमेरिका
Americas	अमेरिकास
Amethi	अमेठी
Amey	अमेय
Amir	अमीर
Amiral	अमीरल
Amish	अमिश
Amita	अमिता
Amitaabh	अमिताभ
Amitesh	अमितेश
Amitvikram	अमितविक्रम
Amla	अम्ला
Amla	आम्ला
Amlai	अम्लाई
Amlankusum	अम्लानकुसुम
Amloh	अमलोह
Amman	अम्मान
Amod	अमोद
Amoghaa	अमोघा
Amolak	अमोलक
Amooly	अमूल्य
Amory	एमोरी
Amr	अम्र
Amrapali	आम्रपाली
Amrataa	अमृता
Amravati	अमरावती
Amre	आम्रे
Amrita	अमृता
Amritap	अमृतप
Amritesh	अमृतेश
Amriteshaya	अमृतेशय
Amriteshvar	अमृतेश्वर
Amriteshwar	अमृतेश्वर
Amritkala	अमृतकला
Amritlal	अमृतलाल
Amroha	अमरोहा
Amsterdam	एमस्टरडॅम
Amsterdam	एमस्टरडैम
Amu	अमू
Amuly	अमूल्य
Amy	एमी
Anaam	अनाम
Anaamika	अनामिका
Anadi	अनादी
Anagh	अनघ
Anagha	अनघा
Anahitaa	अनहीता
Anakapalle	अनाकापल्ले
Anala	अनला
Anan	अनान
Ananda	आनंद
Anandamayi	आनंदमयी
Anandini	आनंदिनी
Anant	अनंत
Anantapur	अनंतपुर
Anantaroop	अनंतरूप
Anantarup	अनंतरूप
Anantraam	अनंतराम
Anantroop	अनंतरूप
Anany	अनन्य
Ananyaj	अनन्यज
Anapay	अनपय
Anar	अनार
Anara	अनारा
Anasah	अनसाह
Anastasia	एनेस्तेसिया
Ancelin	एंसेलीन
Anchal	आंचल
And	एण्ड
Andaaz	अंदाज
Andal	अंदल
Andalib	अन्दलिब
Andaman	अंदमान
Andher	अंधेर
Andhere	अंधेरे
Andheri	अंधेरी
Andhi	अंधी
Andhon	अंधों
Andhra	आंध्र
Andhra	आंध्रा
Andolan	आंदोलन
Andoy	एन्डॉय
Andra	एण्ड्रा
Andreas	आंद्रियास
Andrew	एण्ड्रयु
Andrew	एण्ड्रयू
Andrew	एण्ड्रू
Andrews	एण्ड्रयूस
Andros	एण्ड्रॉस
Andy	एण्डी
Anees	अनीस
Angaara	अंगारा
Angaarey	अँगारे
Angaarey	अंगारे
Angaarika	अंगारिका
Angaarikaa	अंगारिका
Angad	अंगद
Angara	अंगारा
Angaraj	अंगराज
Angarakshak	अंगरक्षक
Angela	एंजिला
Angela	एंजेला
Angelica	एंजेलिका
Angelina	एंजेलिना
Angiotech	एन्जियोटेक
Angle	एंगल
Anglia	एंग्लिया
Angoothi	अंगूठी
Angraaj	अंगराज
Angraj	अंगराज
Anguree	अंगूरी
Angus	अंगुस
Angus	एंगस
Anhoni	अनहोनी
Anikaa	अनिका
Animation	एनिमेशन
Anish	अनीश
Anisur	अनीसुर
Anita	अनिता
Anjaam	अंजाम
Anjaan	अंजान
Anjaana	अंजाना
Anjaane	अंजाने
Anjali	अंजली
Anjana	अंजना
Anjane	अंजाने
Anjane	अनजाने
Anjani	अंजनी
Anjasaa	अंजसा
Anjhi	अंझी
Anju	अंजु
Ankai	अंकाई
Ankh	अंख
Ann	एन
Annapoornaa	अन्नपूर्णा
Anneliese	एन्नेलीज
Annigeri	अन्नीगेरी
Annissa	एन्निसा
Annora	एन्नोरा
Anokha	अनोखा
Anou	अनाउ
Ansari	अंसारी
Anshul	अंशुल
Anshumat	अंशुमत
Ansoo	आंसू
Anstice	एंस्टीस
Antalya	अंताल्या
Antaraa	अंतरा
Antarah	अंतराह
Antarasingh	अंतरसिंह
Antares	एंटेरस
Anth	अंत
Antimony	एंटीमनी
Antioch	एंटिओक
Antonia	एंटोनिया
Antonie	एंटोनी
Antony	एंटनी
Anugamita	अनुगामिता
Anugamitaa	अनुगामिता
Anuhya	अनुह्या
Anuj	अनुज
Anumati	अनुमति
Anupgarh	अनुपगड
Anuppur	अनुपपुर
Anupshahr	अनुपशहर
Anuraadhaa	अनुराधा
Anuraag	अनुराग
Anuradha	अनुराधा
Anurasiri	अनुरसीरी
Anurodh	अनुरोध
Anuva	अनुवा
Anuvaa	अनुवा
Anuyayita	अनुयायिता
Anvil	एन्विल
Anwar	अनवर
Anwesha	अन्वेशा
Anweshaa	अन्वेशा
Aoulakh	औलख
Apana	अपना
Aparaajitaa	अपराजिता
Aparados	ऍपाराडोस
Aparnesh	अपर्णेश
Apatkaal	आपातकाल
Apna	अपना
Apni	अपनी
Apollo	अपोलो
Apoorva	अपूर्व
Apple	एप्पल
Applebee	एपलबी
Appollo	अपोलो
Apraa	अपरा
April	एप्रिल
Apte	आपटे
Apurva	अपूर्वा
Aqeelah	अकीलाह
Ar	अर
Ara	आरा
Araafaat	अराफात
Arabella	एराबेला
Arabi	अरबी
Arabian	अरेबीयन
Arad	एरड
Aragon	एरागन
Arakku	अराकु
Aral	अरल
Aram	आराम
Araria	अरारिया
Arariya	अरारिया
Arati	आरती
Aravalli	अरावली
Aravankadu	अरावांकडु
Arche	आर्क
Archeology	आर्कोलॉजी
Archibald	आर्कीबाल्ड
Archit	अर्चित
Arcolab	आर्कोलैब
Arcos	आर्कोस
Ardh	अर्ध
Ardhangini	अर्धांगिनी
Ardnacrusha	अर्दनाक्रुशा
Aretha	एरेथा
Areva	अरीवा
Argentina	अर्जेन्टीना
Argheshvar	अर्घेश्वर
Argheshvara	अर्घेश्वर
Argheshwar	अर्घेश्वर
Argonia	अर्गोनिया
Ariana	एरिएना
Ariane	एरियन
Arib	अरीब
Arissa	एरिसा
Aristotle	एरिस्टॉटल
Aristotle	एरीस्टोटल
Ariyalur	अरियालुर
Arjumand	अर्जुमन्द
Arkaj	अर्कज
Arkansas	अर्कन्सास
Arkansas	अर्कांसास
Arket	आरकट
Arlanda	अरलैंडा
Arlen	अर्लेन
Arlene	एरलीन
Arlo	अर्लो
Armande	आर्मंड
Armelle	आर्मेल
Armen	आर्मेन
Armina	आर्मीना
Arneja	अरनेजा
Arnetha	अर्नेठा
Arnhem	अरन्हेम
Arni	अर्नी
Arnie	एर्नी
Arora	अरोरा
Arpanaa	अर्पणा
Arpita	अर्पिता
Ars	अर्स
Arsenic	आर्सेनिक
Arshia	अर्शिया
Artan	एर्टन
Arth	अर्थ
Arthur	अर्थर
Arthur	आर्थर
Arthur	ऑर्थर
Artistic	आर्टिस्टिक
Arts	आर्टस
Arty	आर्टी
Arub	अरुब
Arumugan	अरुमुगन
Arunachaleshwar	अरूणाचलेश्वर
Arunesh	अरुणेश
Arunima	अरुणिमा
Arunpriya	अरुणप्रिया
Aruppukottai	अरूपुकोताई
Arusha	अरुशा
Arva	अर्वा
Arvi	अर्वी
Arvind	अरविंद
Arzoo	आरजू
Asaavaree	असावरी
Asaavari	असावरी
Asad	असद
Asafpur	आसफपुर
Asahi	असाही
Asahi	आशी
Asaoti	असौती
Asar	असर
Asavaree	असावरी
Ashaa	आशा
Ashadh	आषाढ
Ashant	अशांत
Ashanti	अशांति
Ashapurna	आशापूर्णा
Asharaf	अशरफ
Ashby	एश्बी
Ashby	ऐशबाय
Ashcroft	एशक्रॉफ्ट
Ashes	एशेस
Ashfaq	अश्फाक
Ashiq	आशिक
Ashique	आशिक
Ashivan	अशिवन
Ashley	ऐश्ले
Ashlyn	एशलीन
Ashok	अशोक
Ashraful	अशराफल
Ashrayash	आश्रयश
Ashtputre	अष्टपुत्रे
Asia	आसिया
Asif	आसीफ
Asif	आसिफ
Asiya	आसिया
Aslesha	अश्लेषा
Asli	असली
Asmita	अस्मिता
Asom	असोम
Asomiya	असोमिया
Aspasia	एस्पासिया
Aspreva	एस्प्रेवा
Assam	आसाम
Assembly	असेंबली
Assembly	असेंब्ली
Association	एसोसिएशन
Asta	अस्ता
Astatine	एस्टाटिन
Aston	ऐस्टन
Astra	एस्ट्रा
Astrazeneca	एस्ट्राजेनेका
Astronomical	एस्ट्रोनोमिकल
Aswan	अस्वान
Ata	आता
Atabaque	अताबैक
Atacama	अटाकामा
Atahar	अतहर
Atal	अटल
Atalanta	अटलांटा
Atalo	एटलो
Atanu	अतनु
Atari	अटारी
Athabasca	अथाबास्का
Athar	अथार
Atharvan	अथर्वन
Atherton	एथर्टन
Athilah	अथिलाह
Athiya	अथिया
Athletics	एथलेटिक्स
Atif	आतिफ
Atindar	अतिंदर
Atindarjeet	अतिंदरजीत
Atinderjit	अतिंदरजीत
Atishbaaz	आतिशबाज
Atlantic	अटलांटिक
Atma	आत्मा
Atmajyoti	आत्मज्योति
Atmanand	आत्मानंद
Atmaram	आत्माराम
Atnu	अतनु
Atrampur	अत्रामपुर
Atrauli	अत्रौली
Atreya	अत्रेया
Atreyaa	अत्रेया
Atreyee	अत्रेयी
Atreyi	अत्रेयी
Atri	अत्रि
Atru	अटरू
Attabira	अत्ताबिरा
Attacker	अटैकर
Attar	अट्टार
Attariwala	अट्टारीवाला
Atticus	एट्टीकस
Attunity	एट्टयूनिटी
Auchan	ऑचन
Audra	ऑड्रा
Audrain	ऑड्रेन
Augrabies	ऑग्राबीस
August	ऑगस्ट
Augusta	ऑगस्ता
Aulad	औलाद
Aurar	औरार
Aurelia	ऑरेलिया
Aurobindo	ऑरोबिंदो
Aurobindo	ओरोबिंदो
Aurorette	औरोरेट
Aurvashey	और्वशेय
Austine	ऑस्टीन
Australian	ऑस्ट्रेलियन
Austrian	ऑस्ट्रियन
Authority	ऑथॉरिटी
Autom	ऑटम
Automotive	ऑटोमोटिव
Autos	ऑटोज
Auwa	औवा
Ava	एवा
Avadhi	अवधि
Avadi	अवादी
Avalbane	एवाल्बेन
Avaninder	अवनिंदर
Avantikaa	अवंतिका
Avarielle	एवरिएल
Avataar	अवतार
Avaya	अवया
Avel	एवेल
Avenger	एवेंजर
Averoff	एवरॉफ
Avian	एवियन
Avikshit	अविक्षत
Avinaash	अविनाश
Avinashi	अविनाशी
Avishka	अविश्का
Aviva	अवीवा
Aviz	एविज़
Avril	एव्रिल
Avtar	अवतार
Awaara	आवारा
Awara	आवारा
Award	अवार्ड
Awena	एवेना
Axcan	एक्सकेन
Axel	एक्सेल
Ayachit	आयाचित
Aye	आई
Aye	आये
Ayee	आई
Ayn	एन
Ayushmaan	आयुष्मान
Ayyaash	अय्याश
Ayyappa	अय्यप्पा
Ayyappaa	अय्यप्पा
Ayyappan	अय्यप्पन
Ayyar	अय्यर
Azad	आजाद
Azad	आझाद
Azadpur	आजादपुर
Azahar	अजहर
Azam	आजम
Azaraaq	अजराक
Azaraqi	अजराकी
Aziz	अजीज
Azmat	अजमत
Azmat	अज्मत
Azove	अजोव
Azraq	अजराक
Azraqee	अजराकी
Azraqi	अजराकी
Azzah	अज्जाह
Baabar	बाबर
Baad	बाद
Baadbaan	बादबान
Baalakrishna	बालकृष्ण
Baalamohan	बालमोहन
Baalasakhaa	बालसखा
Baalde	बालदे
Baalgopal	बालगोपाल
Baalmani	बालमणि
Baap	बाप
Baaqee	बाकी
Baari	बारी
Baarish	बारिश
Baawri	बावरी
Baazigar	बाजीगर
Baba	बाबा
Babagon	बाबागोन
Babar	बाबर
Babarpur	बाबरपुर
Babatpur	बाबतपुर
Babbar	बब्बर
Babrala	बाब्रला
Babruysk	बैब्रुइस्क
Babugarh	बाबूगड
Bachao	बचाओ
Bachcha	बच्चा
Bachchey	बच्चे
Bachchon	बच्चो
Bachhrawan	बछरावन
Bachu	बचू
Backbone	बेकबोन
Bacon	बेकन
Bad	बेड
Badakhshi	बदाख्शी
Badalte	बदलते
Badampudi	बादामपुड़ी
Badan	बदन
Badarpur	बदरपुर
Badaruddeen	बदरुद्दीन
Badayoon	बदायून
Baddoor	बद्दूर
Baddowal	बद्दोवाल
Badee	बडी
Badel	बडेल
Badhti	बढती
Badhu	बधू
Badi	बडी
Badi	बदी
Badlapur	बदलापुर
Badle	बदले
Badli	बदली
Badmaash	बदमाश
Badminton	बैडमिंटन
Badnam	बदनाम
Badnapur	बदनापुर
Badree	बद्री
Badreenaath	बद्रीनाथ
Badri	बद्री
Badrinath	बद्रीनाथ
Badrudeen	बद्रुदीन
Badshah	बादशाह
Badwasi	बदवासी
Bagaha	बागाहा
Bagalkot	बागलकोट
Bagevadi	बागेवादी
Baghauli	बघौली
Baghawat	बगावत
Baghban	बागबान
Baghpat	बाघपत
Bagri	बागरी
Bahadurgarh	बहादुरगड
Bahadurpur	बहादुरपुर
Bahali	बहाली
Bahamas	बहामास
Baharia	बहारिया
Baharon	बहारो
Bahauddin	बहाउद्दीन
Bahaudeen	बहाउद्दीन
Bahaudin	बहाउद्दीन
Bahen	बहन
Bahgat	बहगत
Bahhath	बहाथ
Bahia	बहिया
Bahilpurwa	बाहिलपुरवा
Bahir	बहिर
Bahiru	बहिरू
Bahiyudeen	बहियुद्दीन
Bahiyy	बहिय
Bahjoi	बहजोई
Bahlol	बहलोल
Bahnod	बाहनोद
Bahon	बाँहो
Bahon	बाहो
Bahrain	बहरीन
Bahrupiya	बहरूपिया
Bahurup	बहुरूप
Bahut	बहुत
Bahutule	बहुतुले
Baiju	बैजु
Baikal	बैकल
Bairagarh	बैरागड
Bairagnia	बैरागनिया
Baishali	बैशाली
Baje	बाजे
Bajeel	बजील
Baji	बाजी
Bakawali	बकावली
Bakhtawar	बख्तावर
Bakhtiaar	बख्तियार
Bakhtiar	बख्तियार
Bakkai	बक्काई
Bakkir	बकीर
Bakr	बक्र
Bakra	बकरा
Bala	बाला
Balachandra	बालचंद्र
Baladev	बालदेव
Baladi	बलादी
Balajee	बालाजी
Balaji	बालाजी
Balakrishna	बालकृष्ण
Balam	बलम
Balamu	बलामु
Balance	बैलेंस
Balaraaj	बलराज
Balaraj	बलराज
Balaram	बलराम
Balasore	बालासोर
Balaveer	बलवीर
Balboa	बल्बोआ
Balchandra	बालचंद्र
Balearic	बालैरिक
Baleel	बलील
Baleshvar	बालेश्वर
Balgovind	बालगोविंद
Balidan	बलिदान
Baligh	बालिग
Balil	बलिल
Balj	बल्ज
Balkhash	बलखश
Balkrishna	बालकृष्ण
Balla	बॅला
Ballabgarh	बल्लबगड
Ballaleshwar	बल्लालेश्वर
Ballarat	बल्लारत
Ballard	बेलर्ड
Ballari	बल्लरी
Ballarpur	बल्लरपुर
Ballia	बालिया
Balmer	बालमेर
Balmohan	बालमोहन
Balram	बलराम
Balsamand	बलसामंद
Baltic	बाल्टिक
Baluran	बालुरान
Balvindar	बलविंदर
Balwan	बलवान
Balwinder	बलविंदर
Balyogi	बालयोगी
Bama	बामा
Bamanheri	बमनहेरी
Bamba	बांबा
Bamba	बैंबा
Bambai	बंबई
Bamboo	बैम्बू
Bambuca	बैंबूका
Bamhani	बमहानी
Bamhrauli	बम्हरौली
Bamnia	बमनिया
Bamra	बामरा
Ban	बन
Banamala	बनमाला
Banane	बनने
Banani	बननी
Banapura	बानापुरा
Banarhat	बनारहट
Banasandra	बनासांद्रा
Banavaareelaal	बनवारीलाल
Banco	बैन्को
Bancroft	बेंक्रोफ्ट
Band	बंद
Band	बैंड
Bandana	बन्दना
Bandanwara	बंदनवारा
Bandekar	बांदेकर
Bandel	बंदेल
Bandera	बैंडेरा
Bandh	बंद
Bandh	बंध
Bandhula	बंधुला
Bandi	बंदी
Bandikui	बांदीकुई
Bandish	बंदिश
Bandoneon	बैंडोनियन
Bandurria	बंदुरिया
Bangar	बांगड़
Bangla	बंगला
Bangla	बंग्ला
Bangrod	बंगरोड
Bangui	बैंगुई
Baniya	बनिया
Bankata	बंकाता
Bankebihaari	बांकेबिहारी
Bankim	बंकिम
Banks	बैंक्स
Banmor	बानमोर
Bannariamman	बन्नारीअम्मन
Banner	बैनर
Bannerghatta	बानेरघटटा
Banqiao	बैंकियाओ
Bansari	बंसरी
Bansee	बंसी
Banseelal	बंसीलाल
Bansilal	बंसीलाल
Banthida	बनठिंडा
Banujah	बनुजाह
Banwet	बनवेट
Bapat	बापट
Baptiste	बैपटिस्ट
Baptiste	बैप्टिस्ट
Baqa	बका
Baqir	बाकीर
Barabanki	बराबांकी
Barabhum	बराभूम
Barabil	बराबिल
Barad	बराड
Baragaon	बडागांव
Barah	बारह
Barakaat	बराकात
Baramua	बारामुआ
Baran	बरन
Baran	बाराँ
Barat	बरात
Barbados	बार्बडोस
Barbara	बारबरा
Barcelona	बार्सिलोना
Barcelona	बार्सेलोना
Barchi	बारची
Barchon	बार्कन
Barclays	बरक्लैज
Bardhaman	बर्धमान
Bareilly	बरेली
Bareli	बरेली
Bareta	बरेटा
Bareth	बरेथ
Bargawan	बरगावन
Barium	बेरियम
Barkakana	बरकाकाना
Barkandi	बरकंदी
Barkat	बरकत
Barkha	बरखा
Barlow	बारलो
Barmer	बारमेर
Barmi	बरमी
Barn	बार्न
Barnali	बर्नाली
Barnwell	बार्नवेल
Baroda	बरोडा
Barrackpore	बैरकपुर
Barrah	बर्रह
Barrani	बर्रानी
Barrow	बैरॉ
Barry	बेरी
Barsaat	बरसात
Barsat	बरसात
Barsha	बर्षा
Barsoi	बरसोई
Bart	बार्ट
Bartaman	बर्तमान
Barua	बरुआ
Barun	बरुन
Baruna	बरुणा
Baruva	बरुवा
Barwa	बरवा
Barwadih	बरवादिह
Barwaha	बरवाहा
Bas	बस
Basant	बसंत
Basava	बसावा
Baseball	बेसबॉल
Basel	बासेल
Bashirah	बशीराह
Basimah	बसिमाह
Basit	बासित
Baske	बस्के
Basketball	बास्केटबॉल
Basmah	बस्माह
Basoda	बसोदा
Basoos	बसूस
Basri	बसरी
Bass	बास
Bassa	बस्सा
Bassaseachi	बसासेची
Bastami	बस्तामी
Basti	बस्ती
Baswa	बस्वा
Batang	बतांग
Bath	बाथ
Batool	बतूल
Battery	बॅटरी
Battery	बैटरी
Battice	बैटिस
Battler	बैट्लर
Baudh	बाउथ
Baudin	बॉडिन
Bauhaus	बौहाउस
Bauli	बाउली
Bavarian	बवेरीयन
Bavla	बावला
Bawa	बावा
Bawal	बवाल
Bawani	बवानी
Baweja	बवेजा
Bayana	बयाना
Bayard	बेयार्ड
Bayer	बायर
Bayer	बेयर
Bayfield	बेफील्ड
Bayonne	बायोने
Baytu	बैतु
Bazaar	बाजार
Baze	बेझ
Bazid	बाजीद
Beach	बीच
Beacons	बिकॉन्स
Beam	बीम
Bear	बीयर
Beard	बियर्ड
Beas	बिस
Beawar	ब्यावर
Bebus	बेबस
Becker	बेकर
Bedard	बेदर्द
Bedreddin	बेद्रेद्दीन
Bedroom	बेडरूम
Beena	बीना
Bees	बीस
Beete	बीते
Beeti	बीती
Begaana	बेगाना
Begaane	बेगाने
Begampet	बेगमपत
Behen	बहन
Behti	बहती
Beirut	बैरूत
Bejunctional	बेजंक्शनल
Bektash	बेकताश
Bel	बेल
Bela	बेला
Belagaam	बेलगाम
Belampalli	बेलमपाली
Belan	बेलन
Belgaum	बेलगाम
Belisario	बेलिसारियो
Bell	बेल
Bellerophon	बेलरोफोन
Bello	बेलो
Belpre	बेलप्रे
Belrayan	बेलरेयान
Belthara	बेलठारा
Benazeer	बेनजीर
Benbow	बेनबॉ
Benedetto	बेनेडेटो
Beneficence	बेनेफिसेंस
Benicia	बेनिसिआ
Benoist	बेनोइस्ट
Benson	बेंसन
Bent	बेंट
Beqasoor	बेकसूर
Berchha	बेरचा
Berhampore	बरहमपोर
Berhampur	बरहमपुर
Beris	बेरिस
Berkelium	बर्कीलियम
Berle	बर्ली
Bernard	बरनार्ड
Bernard	बर्नार्ड
Bernie	बर्नी
Bert	बर्ट
Beryllium	बेरीलियम
Beshaque	बेशक़
Besharam	बेशरम
Beskidy	बेस्किडी
Besroli	बेसरोली
Best	बेस्ट
Betaab	बेताब
Betavad	बेतावद
Betiya	बेटिया
Betma	बेटमा
Bette	बॅटी
Betts	बेट्स
Betty	बेट्टी
Betwa	बेतवा
Bevan	बेवन
Bhaanuchand	भानुचंद
Bhaanumukhee	भानुमुखी
Bhaarateey	भारतीय
Bhaaskar	भास्कर
Bhabhi	भाभी
Bhabua	भाभुआ
Bhachau	भचउ
Bhadbhade	भडभडे
Bhadbhoke	भाडभोके
Bhadli	भदली
Bhadohi	भदोही
Bhadon	भादो
Bhadrak	भद्रक
Bhadsawale	भडसावले
Bhaga	भगा
Bhagam	भागम
Bhagawan	भगवान
Bhagok	भागोक
Bhagta	भगता
Bhagwan	भगवान
Bhagwanpur	भगवानपुर
Bhagwanpura	भगवानपुर
Bhagwant	भगवंत
Bhagwantroop	भगवंतरूप
Bhagwat	भगवत
Bhagyaraj	भाग्यराज
Bhairav	भैरव
Bhaiya	भइया
Bhaiya	भैया
Bhakti	भक्ति
Bhala	भला
Bhala	भाला
Bhali	भाली
Bhalki	भालकी
Bhalwan	भल्वान
Bham	भाम
Bhambhra	भांभरा
Bhamini	भामिनी
Bhana	भाणा
Bhandak	भंदक
Bhandara	भंडारा
Bhanja	भांजा
Bhanumati	भानुमती
Bhanuprasad	भानुप्रसाद
Bharani	भरनी
Bharat	भारत
Bharath	भारथ
Bharati	भारती
Bharatkund	भरतकुंड
Bharatpur	भरतपुर
Bhare	भरे
Bharni	भरनी
Bharosa	भरोसा
Bharthana	भरथाना
Bhasin	भसीन
Bhaskar	भास्कर
Bhata	भाटा
Bhatel	भटेल
Bhatija	भतीजा
Bhatinda	भटिंडा
Bhatiya	भाटिया
Bhatkal	भटकल
Bhaton	भटों
Bhatta	भट्टा
Bhattacharya	भट्टाचार्य
Bhatti	भट्टी
Bhaunra	भौवरा
Bhavanisagar	भवानीसागर
Bhavatmaj	भावत्मज
Bhavna	भावना
Bhavnagar	भावनगर
Bhawani	भवानी
Bhawanipur	भवानीपुर
Bhayavadar	भयवदर
Bhedi	भेदी
Bheegi	भीगी
Bheelwada	भीलवाडा
Bheem	भीम
Bheema	भीमा
Bheeshm	भीष्म
Bhemswadi	भेमस्वादी
Bhesana	भेसाना
Bhilai	भिलाई
Bhimana	भिमाना
Bhimashankar	भीमाशंकर
Bhimavaram	भीमावरम
Bhindaranwale	भिंडरनवाले
Bhindra	भिंडरा
Bhishma	भीष्म
Bhivani	भिवानी
Bhodwal	भोदवल
Bhogle	भोगले
Bhone	भोने
Bhoo	भू
Bhoola	भूला
Bhoomika	भूमिका
Bhoot	भूत
Bhoun	भौण
Bhoura	भौरा
Bhuchchu	भुच्चु
Bhudhar	भूधर
Bhudraj	भुदराज
Bhuj	भुज
Bhula	भुला
Bhulon	भुलो
Bhumika	भूमिका
Bhunch	भुंच
Bhupen	भूपेन
Bhupia	भूपिया
Bhupinder	भूपिंदर
Bhuppal	भुप्पल
Bialego	बायलेगो
Biathlon	बैथलन
Bibhavasu	बिभावसु
Bickle	बिकल
Bicycling	बायसायकलिंग
Bidhan	बिधान
Bidupur	बिदुपुर
Biesbroeck	बिसब्रोएक
Bieszczady	बिइस्जक्जाडी
Bighorn	बिगहॉर्न
Bihari	बिहारी
Bij	बिज
Bijaysota	बिजयसोटा
Bijrotha	बिजरोठा
Bike	बाइक
Biking	बाइकिंग
Biking	बाईकिंग
Bilcare	बिलकेयर
Bildi	बिलदी
Bilhaur	बिल्हौर
Bilimora	बिलिमोरा
Bilingual	बिलींगुअल
Bilkha	बिल्खा
Billi	बिल्ली
Billiards	बिलियर्डस
Billy	बिली
Bilpur	बिलपुर
Bilqis	बिल्किस
Bilwai	बिल्वाई
Bimal	बिमल
Bin	बिन
Binata	बिनता
Bindki	बिंदकी
Bindusar	बिन्दुसर
Bing	बिंग
Bingham	बिंघैम
Biniou	बिनिउ
Binjal	बिंजल
Binnaguri	बिनागुरी
Biomira	बायोमिरा
Biotech	बायोटेक
Biotechnology	बायोटेक्नोलॉजी
Bipasha	बिपाशा
Biradari	बिरादरी
Birambad	बिरामबाद
Birang	बिरंग
Birangi	बिरंगी
Birdi	बिरदी
Birha	बिरह
Birju	बिरजू
Birlanagar	बिर्लानगर
Birlasoft	बिर्लासॉफ्ट
Birmitrapur	बिरमित्रापुर
Birr	बिर
Birsinghpur	बिरसिंहपुर
Birur	बिरुर
Bisanasinh	बिसनसिंह
Biscayne	बिस्केन
Bishakha	बिशाखा
Bishan	बिशन
Bishr	बिश्र
Bismila	बिस्मिल्ला
Bissau	बिसौ
Bitti	बिट्टी
Biwii	बीवी
Biyavra	ब्यावरा
Bk	बैंक
Blading	ब्लेडिंग
Blair	ब्लेअर
Blair	ब्लेयर
Blake	ब्लेक
Blakey	ब्लैकी
Blauwkapel	ब्लौकापेल
Bleach	ब्लीच
Blewett	ब्लेवेट
Bliss	ब्लिस
Bloomberg	ब्लूमबर्ग
Blue	ब्लू
Blue	ब्ल्यू
Bluenose	ब्लूनोज
Bluephoenix	ब्लूफोनिक्स
Bob	बॉब
Bobas	बोबस
Bocaina	बोकायना
Bodas	बोडस
Bodeli	बोदेली
Bodhran	बोधरन
Bogota	बोगोटा
Boinda	बोइंदा
Bokaro	बोकारो
Bokha	बोखा
Bokil	बोकिल
Bolai	बोलई
Bolbala	बोलबाला
Bolivia	बोलिविया
Bombarde	बॉम्बार्डे
Bombo	बॉम्बो
Bond	बॉन्ड
Bone	बोने
Bongaigaon	बॉन्गाईगांव
Bonjol	बॉन्जल
Bonn	बॉन
Bonnai	बोन्नाई
Bonnet	बोनेट
Bontebok	बॉन्टेबॉक
Bony	बोनी
Boock	बूक
Booderee	बूडेरी
Boogie	बूगी
Boon	बून
Boons	बून्स
Borgaon	बोरगांव
Borivali	बोरीवली
Borwankar	बोरवनकर
Bosque	बॉस्क
Bossa	बोस्सा
Boston	बोस्टन
Botad	बोताद
Botecita	बॉटेसिटा
Boteju	बोतेजू
Botetourt	बॉटेटोर्ट
Botham	बोथम
Bottom	बॉटम
Boucher	बोचर
Boudhayan	बुद्धायन
Bougainville	बोगनविलीया
Boun	बाउन
Bouvet	बॉवेट
Bouzouki	बौजौकी
Bovisand	बॉविसैंड
Bowden	बॉडन
Bowie	बॉवी
Boxer	बॉक्सर
Boyard	बॉयार्ड
Boyce	बॉएस
Boys	बॉयज
Bradford	ब्रॅडफोर्ड
Bradford	ब्रैडफोर्ड
Brady	ब्रेडी
Bragg	ब्रैग
Brahmachari	ब्रह्मचारी
Brahmadutt	ब्रह्मदत्त
Brain	ब्रेन
Brandeis	ब्रेंडीस
Brandenburg	ब्रेडनबर्ग
Brandenburg	ब्रेन्डनबर्ग
Brando	ब्रेंडो
Brasil	ब्राझील
Bratsk	ब्रत्स्क
Braunschweig	ब्रॉन्स्वेग
Brazosport	ब्राझोस्पोर्ट
Bread	ब्रेड
Brendan	ब्रेंडन
Brent	ब्रेंट
Brevard	ब्रेवार्ड
Brewerie	ब्रेवेरी
Brian	ब्रायन
Bridge	ब्रिज
Bridgeport	ब्रिजपोर्ट
Bridger	ब्रिजर
Bridges	ब्रिजेस
Bridgewoods	ब्रिजवुड्स
Brijesh	ब्रिजेश
Brinkley	ब्रिंक्ले
Briscoe	ब्रिस्को
Bristol	ब्रिस्टल
Bristol	ब्रिस्टॉल
Brit	ब्रिट
British	ब्रिटिश
Britt	ब्रिट
Broads	ब्रॉड्स
Broadwater	ब्रॉडवाटर
Broechem	ब्रोकेम
Bromine	ब्रोमीन
Brook	ब्रूक
Brooklyn	ब्रुकलिन
Bruce	ब्रुस
Bruce	ब्रूस
Bruk	ब्रक
Bryan	ब्रायन
Budaun	बुदौन
Buddh	बुद्ध
Buddhdev	बुद्धदेव
Buddhika	बुद्धिका
Buddhism	बुद्धिज्म
Budgam	बदगम
Buffalo	बफेलो
Buhaysah	बुहायसाह
Buhayyah	बुहैयाह
Building	बिल्डिंग
Bujhakkad	बुझक्कड
Bulandshahr	बुलंदशहर
Bulerias	बूलेरियास
Bulgaria	बुल्गारिया
Bulk	बल्क
Bullet	बुलेट
Bunaken	बुनाकेन
Bundalbaaz	बंडलबाज
Bundi	बूंदी
Bundki	बंदकी
Bundy	बुंडी
Bunge	बंज
Buni	बूनी
Buqayrah	बुकयराह
Buran	ब्यूरेन
Burbank	बरबैंक
Burbara	बारबरा
Burdah	बुर्दाह
Burgoyne	बर्गोइन
Burhwal	बढवाल
Burj	बुर्ज
Burmester	बर्मेस्टर
Burns	बर्न्स
Busayrah	बुसयराह
Bushnells	बुशनेल्स
Butari	बुटारी
Butchart	बुटचर्ट
Butcher	बुचर
Butler	बटलर
Butt	बट्ट
Butte	बट
Bututs	बुटुट्स
Buxar	बक्सर
By	बाय
Byadarahalli	ब्यादराहली
Cable	केबल
Cabo	काबो
Cacahuamilpa	काकाहुआमील्पा
Cachopa	केचोपा
Cadence	केडेंस
Cadi	कैडी
Cadila	कैडिला
Cadmium	कैडमियम
Cady	कैडी
Cael	काएल
Caelan	काएलन
Caesar	कैसर
Cagney	कॅगने
Cahnni	कहन्नी
Caia	केया
Cailean	कैलीन
Caiman	कैमन
Cairbre	केयरब्रे
Cairns	कैर्न्स
Caisse	कैस
Caitlin	कैटलिन
Caja	काजा
Cake	केक
Cala	केला
Calabash	कैलाबश
Calandra	कैलेंड्रा
Calantha	कैलेंथा
Calcining	कैल्सिंइंग
Calcutta	कलकत्ता
Caledonian	कैलेडोनियन
Calf	काफ
Californium	कैलिफोर्नियम
Calix	कैलिक्स
Call	कॉल
Callaghan	कैलाघन
Callaway	कैलावे
Callen	कैलेन
Calliope	कैलियोप
Callista	कैलिस्ता
Calum	कैलम
Calvary	क्लेवरी
Calvine	कैल्विन
Cambridge	कैंब्रिज
Camecuaro	कामेकुआरो
Cameron	केमरॉन
Cameron	कैमरन
Cameron	कैमरॉन
Camila	कैमिला
Camille	कैमिल
Campion	कैंपियन
Canaan	कॉनान
Canacona	कनाकोना
Canada	कनाडा
Canadian	कैनेडियन
Canal	केनाल
Canaria	कनारिया
Canastra	केनास्ट्रा
Canberra	कैनबरा
Canberra	कैनबेरा
Cancer	कैंसर
Candra	कैंड्रा
Candy	कैंडी
Canellopoulos	कैनलोपॉलस
Canfield	कैनफील्ड
Cannanore	कन्नानोर
Canoe	कैनो
Canopus	कैनॉपस
Cansaulim	कनसौलिम
Cantara	कैंटर
Canterbury	कैंटरबरी
Capellen	कैपलन
Capital	केपिटल
Capital	कैपिटल
Capivara	केपिवारा
Capivara	कैपीवारा
Caprice	कैप्रिस
Capricorn	कैप्रीकॉर्न
Capucine	कैप्यूसिन
Caracas	काराकस
Caracciolo	केरासिओलो
Caraf	कैराफ
Cardiff	कार्डिफ
Caressa	कैरेसा
Caresse	कैरेसी
Carina	कैरीना
Carioca	कैरिओका
Carl	कार्ल
Carli	कार्ली
Carlisle	कार्लिस्ले
Carlos	कार्लोस
Carlotta	कर्लोटा
Carlton	कार्लटन
Carly	कार्ली
Carlyn	कारलिन
Carlynda	कारलिंडा
Carmel	कारमेल
Carnot	कार्नोट
Caroline	कैरोलिन
Caroline	कैरोलीन
Carolos	करोलोस
Carolyn	कैरोलिन
Caroun	कैरोन
Carpathian	कापार्थिअन
Carper	कार्पर
Carroll	करोल
Carroll	केरोल
Carroll	कैरॉल
Carson	कार्सन
Carter	कार्टर
Cartoon	कार्टून
Cartwright	कार्टराइट
Cary	केरी
Carys	कैरिस
Cascada	कॅस्कादा
Cascata	कैस्केटा
Casey	कॅसी
Cashlin	कैशलिन
Cassia	केसिया
Cassie	कैसी
Cassius	कैसियस
Castelfidardo	कैसलफिडार्डो
Castro	कॅस्ट्रो
Cate	कैटलिन
Catherine	कैथरीन
Catherine	कैथलिन
Cato	केटो
Catskill	केत्स्किल
Cavalier	कवालियर
Cavour	केवौर
Cayenne	कैनी
Cecilia	सेसिलिया
Cedric	सेड्रिक
Celestine	सेलेस्टीन
Celina	सेलिना
Celine	सेलीन
Cellebes	सेलेबेस
Cements	सीमेंट्स
Center	सेंटर
Center	सेन्टर
Central	सेन्ट्रल
Centre	सेंटर
Centre	सेन्टर
Centrica	सेन्ट्रिका
Cents	सेंट्स
Century	सेंच्युरी
Century	सेंच्यूरी
Ceramics	सिरेमिक्स
Cerium	सीरियम
Cervantes	सेरवैनटेस
Cesar	केसर
Chaal	चाल
Chaamd	चांद
Chaamundaa	चामुंडा
Chaani	चानी
Chabbra	छाबडा
Chacachua	चाकाचुआ
Chacha	चाचा
Chadda	चड्डा
Chadotar	चदोतर
Chaela	चाएला
Chaeli	चाएली
Chaha	चाहा
Chahal	चहल
Chahiye	चाहिए
Chailyn	चाइलिन
Chain	चैन
Chaitan	चैतन
Chaitanya	चैतन्य
Chaitrasakha	चैत्रसखा
Chakdaha	चकदाहा
Chakram	चक्रम
Chakravarty	चक्रवर्ती
Chakri	चाकरी
Chakshu	चक्षु
Chaksu	चाकसू
Chal	चल
Chalaak	चालाक
Chale	चले
Chalsie	चैल्सी
Chalta	चलता
Chalte	चलते
Chalthan	चल्थन
Chalu	चालू
Chambal	चंबल
Chameli	चमेली
Chamkaur	चमकौर
Chamke	चमके
Chamkee	चमकी
Champa	चम्पा
Champak	चम्पक
Champawat	चम्पावत
Chamundeshwari	चामुंडेश्वरी
Chanchal	चंचल
Chanchala	चंचला
Chanda	चंदा
Chandan	चन्दन
Chandana	चन्दाना
Chandani	चांदनी
Chandanika	चांदनीका
Chandar	चंदर
Chandel	चंदेल
Chanderi	चंदेरी
Chanderiya	चंदेरिया
Chandisar	चंडीसर
Chandlodiya	चांदलोदिया
Chandr	चंद्र
Chandra	चंद्र
Chandra	चन्द्र
Chandrabali	चंद्रबाली
Chandrabhaan	चंद्रभान
Chandrabhan	चंद्रभान
Chandrakaant	चंद्रकांत
Chandrakishore	चंद्रकिशोर
Chandrakumar	चंद्रकुमार
Chandrapid	चंद्रपिद
Chandrashekhar	चन्द्रशेखर
Chandrima	चंद्रिमा
Chandropal	चंद्रोपाल
Chandur	चंदुर
Chaneti	चनेटी
Chaney	चैनी
Chango	चेंगो
Changqing	चांगक्विंग
Changuna	चंगुना
Channani	चन्नानी
Channapatna	चन्नापटना
Channel	चैनल
Channery	कानेरी
Chanpaa	चंपा
Chantel	चैंटल
Chapada	चापाडा
Chapala	चपला
Chapat	चापट
Chaphekar	चाफेकर
Chaplin	चैपलिन
Chappell	चैपल
Chapple	चैपल
Charan	चरण
Charan	चरन
Charango	चरैंगो
Charanpreet	चरनप्रीत
Charbagh	चारबाग
Charbatia	चारबतिया
Charis	चैरिस
Charisma	करिज्मा
Charitha	चरिथा
Charkhi	चरखी
Charl	चार्ल
Charlee	चार्ली
Charleigh	चार्ली
Charlene	चार्लीन
Charles	चार्ल्स
Charleston	चारलेस्टन
Charlie	चार्ली
Charlize	चार्लीज
Charlton	कार्लटन
Charlton	चार्ल्टोन
Charno	चरणों
Charnon	चरणो
Charulata	चारुलता
Charumati	चारुमती
Charuprabha	चारुप्रभा
Charvattur	चारवत्तुर
Charvi	चारवी
Chas	चैस
Chase	चेस
Chata	चाता
Chate	चाटे
Chatresh	चत्रेश
Chattan	चट्टान
Chattane	चट्टाने
Chattergoon	चैटरगून
Chatura	चतुरा
Chaturanan	चतुरानन
Chau	चाउ
Chaucer	चौसर
Chaudfontaine	कॉडफॉन्टेन
Chaudhary	चौधरी
Chaughule	चौघुले
Chauncey	चॉन्सी
Chaure	चौरे
Chauri	चौरी
Chautha	चौथा
Chawa	चावा
Chawal	चावल
Chaz	चैज
Check	चेक
Cheema	चीमा
Chehra	चेहरा
Chehre	चेहरे
Chelsa	चेल्सा
Chelsia	चेल्सिया
Chemancheri	चमनचेरी
Chemicals	केमिकल्स
Chenderoh	चेन्देरोह
Cheng	चेंग
Chengai	चेंगई
Chennai	चेन्नई
Cheriyanad	चेरियानाद
Cherlin	चेर्लिन
Cherokee	चेरोकी
Cheryl	चेरिल
Chetar	चेतार
Chetawani	चेतावनी
Chhabra	छाबडा
Chham	छम
Chhama	छमा
Chhandak	छन्दक
Chhaon	छाव
Chhapi	छपी
Chhapra	छपरा
Chhath	छट
Chhatrapati	छत्रपति
Chhattisgarh	छत्तीसगड
Chhiharta	छिहरटा
Chhora	छोरा
Chhori	छोरी
Chhoti	छोटी
Chhupa	छुपा
Chhupee	छुपी
Chianki	छियांकी
Chiara	चिआरा
Chibhabha	चिभाभा
Chicago	शिकागो
Chidghan	चिद्घन
Chigumbura	चिगमबुरा
Chikalthan	चिकलथन
Chikbalapur	चिकबलपुर
Chikjajur	चिकजाजुर
Chikmangloor	चिकमंगलूर
Chikni	चिकनी
Chikodi	चिकोडी
Childrens	चिल्ड्रन
Childrens	चिल्ड्रन्स
Chile	चिली
Chill	चिल
Chilli	चिल्ली
Chilo	चिलो
Chilton	चिल्टन
Chimanimani	चिमनीमानी
Chinas	चाइनाज
Chinchli	चिंचली
Chindwara	छिन्दवाडा
Chinese	चायनीज
Chinmay	चिन्मय
Chinmayananda	चिन्मयानन्द
Chinna	चिन्ना
Chinnar	चिन्नार
Chintamani	चिंतामणि
Chipanecas	चीपैनकास
Chirai	चिरई
Chirala	चिराला
Chirayinkil	चिरायिंकिल
Chirgaon	चिरगांव
Chirmiri	चिरमिरी
Chishti	चिश्ती
Chitchor	चितचोर
Chitose	चितोस
Chitra	चित्र
Chitra	चित्रा
Chitradurg	चित्रदुर्ग
Chitrakoot	चित्रकूट
Chitrakot	चित्रकूट
Chitraksh	चित्राक्ष
Chitrali	चित्राली
Chitramala	चित्रमाला
Chitrasen	चित्रसेन
Chitrod	चित्रोद
Chittaswarup	चित्तस्वरूप
Chittaurgarh	चित्तौडगड
Chitthi	चिट्ठी
Chittoor	चित्तूर
Chittor	चित्तौड़
Chittor	चित्तौड
Chittorgarh	चित्तौड़गड
Chiyoda	चियोदा
Chloris	क्लोरिस
Cholom	चोलोम
Chomun	चोमन
Chondi	चोंडी
Chopan	चोपन
Chopra	चोपडा
Chopra	चोप्रा
Choquella	चोक्वैला
Chor	चोर
Chori	चोरी
Chorni	चोरनी
Chosla	चोसला
Choti	छोटी
Chouhan	चौहान
Chouth	चौथ
Chowki	चौकी
Chris	क्रिस
Chrissy	क्रिसी
Christ	क्राइस्ट
Christie	क्रिस्टी
Christopher	क्रिस्टोफर
Christy	क्रिस्टी
Chubachha	चुबच्चा
Chuchura	चुचुरा
Chuck	चकलुका
Chuda	चुडा
Chunar	चुनार
Chup	चुप
Churiyan	चुडिया
Churk	चर्क
Cian	सियान
Cicada	सिकाडा
Cicily	सिसिली
Cigna	सिग्ना
Cili	सीली
Cilicia	सिलिसिया
Cillian	सिलियन
Cipo	सिपो
Ciro	सीरो
Cisco	सिस्को
Cissy	सिसी
Citigroup	सिटीग्रुप
City	सिटी
Clair	क्लेयर
Claral	क्लैरल
Clare	क्लेयर
Clarence	क्लेरेंस
Clarence	क्लैरेन्स
Clarissa	क्लेरिसा
Clark	क्लार्क
Clarsach	क्लैरसच
Clatsop	क्लैटसॉप
Claudette	क्लाउडेट
Claudio	क्लॉडियो
Clea	क्लिया
Cleatus	क्लीटस
Cleburne	क्लेबर्न
Clegg	क्लेग
Clem	क्लेम
Clemenceau	क्लेमेंसियू
Clemens	क्लेमेंस
Cleta	क्लेटा
Cliff	क्लिफ
Clifton	क्लिफ्टोन
Clinch	क्लिंच
Clinton	क्लिंटन
Clio	क्लीओ
Close	क्लोस
Clover	क्लोवर
Clutterbuckganj	क्लटरबकगंज
Clyde	क्लाइड
Coach	कोच
Cobh	कोब
Cobsa	कॉब्सा
Cockelbiddy	कॉकेलबिडी
Cod	कॉड
Cofco	कोफ्को
Cofre	कॉफरे
Cognos	कॉग्नोस
Coimbatore	कोयंबतुर
Coldstream	कोल्डस्ट्रीम
Coleridge	कॉलरिज
Coles	कोल्स
Colin	कॉलिन
Colin	कोलिन
Colley	कॉली
Collice	कोलिस
Collins	कॉलिंस
Collis	कॉलिस
Colman	कोलमैन
Colombia	कोलंबिया
Colombo	कोलंबो
Colonial	कलोनिअल
Colonna	कॉलोन्ना
Color	कलर
Colossus	कॉलॉसस
Columbas	कोलंबस
Columbia	कोलंबिया
Columbia	कोलम्बिया
Colusa	कॉलूसा
Colvin	कॉल्विन
Comcast	कॉमकास्ट
Comfort	कम्फर्ट
Commando	कमांडो
Commercial	कमर्शियल
Commie	कॉमी
Common	कॉमन
Communications	कम्युनिकेशन
Communications	कम्युनिकेशन्स
Communications	कम्यूनिकेशन्स
Comorin	कोमोरिन
Company	कंपनी
Compass	कंपास
Compugen	कंप्यूजन
Computer	कंप्युटर
Computer	कंप्यूटर
Computer	कम्प्यूटर्स
Conagra	कोनाग्रा
Conan	कोनन
Concor	कॉनकॉर
Conde	कोन्डे
Condorcet	कॉन्डोर्सेट
Coney	कोने
Confederation	कॉन्फेडरेशन
Congdon	कॉन्गडन
Congregation	कॉन्ग्रेगेशन
Congress	काँग्रेस
Conjunto	कॉन्जून्टो
Connecticut	कनेक्टीकट
Connemara	कोन्नेमारा
Connon	केनॉन
Conocophillips	कोनोकोफिलिप्स
Constance	कॉन्स्टेंस
Constantine	कॉन्स्टेंटाइन
Constantinople	कॉन्स्टेंटिनोपल
Constraction	कंस्ट्रक्शन
Construction	कंस्ट्रक्शन
Contai	कोनटाई
Conte	कॉन्टे
Continents	कॉनटिनेंट्स
Control	कंट्रोल
Controls	कंट्रोल्स
Convent	कॉंन्वेंट
Convent	कॉन्वेंट
Cook	कुक
Cooke	कूक
Coonoor	कुनूर
Copernicus	कॉपरनिकस
Coppola	कोपोला
Coral	कॉरल
Coral	कोरल
Corbett	कॉर्बेट
Cordelia	कॉर्डेलिया
Cordoba	कॉरडोबा
Corel	कोरेल
Corgi	कॉर्गी
Corine	कोरिन
Cornerstone	कॉर्नरस्टोन
Cornish	कॉर्निश
Cornwell	कॉर्नवेल
Coromandal	कॉरोमंडल
Corp	कॉर्प
Corporation	कॉर्पोरेशन
Corridos	कॉरीडोस
Corrie	कॉरी
Cortland	कोर्टलैंड
Corvette	कॉरवेट
Cosgrove	कॉसग्रूव
Cosmo	कोस्मो
Costa	कोस्टा
Cote	कोट
Cottage	कॉटेज
Cotton	कॉटन
Country	कंट्री
Countrywide	कंट्रीवाइड
County	काउंटी
Courage	कॉरेज
Courageous	करेजियस
Courbet	कॉर्बेट
Courier	कुरियर
Court	कोर्ट
Cove	कोव
Covenant	कॉवेनंट
Coventry	कॉवेंट्री
Coventry	कॉवेन्ट्री
Cowan	कॉवन
Cowans	कॉवंस
Creative	क्रिएटिव
Crédit	क्रेडिट
Cretan	क्रिटेन
Crichton	क्रिकटॉन
Cricket	क्रिकेट
Crisil	क्रिसील
Crispin	क्रिस्पिन
Cristobal	क्रिस्टोबल
Cristoforo	क्रिस्टोफोरो
Crockett	क्रॉकेट
Croft	क्रोफ्ट
Croix	क्रोक्स
Cromwell	क्रॉमवेल
Cronos	क्रॉनोस
Crookes	क्रुक्स
Croquet	क्रॉकेट
Cros	क्रॉस
Crosby	क्रॉसबी
Crowe	क्रौ
Crownhill	क्राउनहिल
Cruise	क्रुज
Cruybeke	क्रूबेक
Crystal	क्रिस्टल
Cueca	स्यूका
Cueva	क्युवा
Cuffy	कफी
Cuica	क्युका
Cullen	कुलेन
Cullen	कूलन
Cullinan	क्युलीनन
Cullman	कुलमेन
Cumberland	कंबरलैंड
Cumbres	कंब्रेस
Cumming	क्युमिंग
Cummins	क्युमिंस
Cummins	क्यूमिंस
Cuomo	क्यूमो
Cup	कप
Curium	क्यूरियम
Curry	करी
Curtin	कर्टिन
Cuttack	कटक
Cutter	कटर
Cwen	स्वेन
Cycle	सायकल
Cycling	सायकलिंग
Cymbalom	सिमबैलम
Cyndi	सिंडी
Cynthia	सिंथिया
Czech	चेक
Daad	दाद
Daaka	डाका
Daan	दान
Daandekar	दांडेकर
Daant	दात
Daata	दाता
Daataadaas	दातादास
Dabbah	दब्बाह
Dabengwa	डबेंग्वा
Dabhaura	दभौरा
Dabholkar	दाभोलकर
Dabla	दबला
Dabolim	दबोलिम
Dabra	दाबरा
Dabur	डाबर
Dacia	डेसिया
Dadahur	ददाहूर
Dadar	दादर
Daddy	डैडी
Daduk	डेडुक
Dafydd	डैफिड
Dagabaaz	दगाबाज
Dagan	दगन
Dagmagpur	डगमगपुर
Dahana	दहना
Dahar	दहर
Dahej	दहेज
Dahleez	दहलीज
Dahlia	डेहलिया
Dahma	दाहमा
Daiei	दैई
Daily	डेली
Daisy	डेजी
Daityahan	दैत्यहन
Daiwa	डैवा
Dakaniya	डाकनिया
Dakar	डाकर
Dakha	दाखा
Dakota	डकोटा
Daksha	दक्षा
Dakshari	दक्षारी
Dakshata	दक्षता
Daku	डाकू
Dalal	दलाल
Dalasi	डलासी
Dalauda	दलौदा
Dale	देल
Dalia	डेलिया
Daliganj	डालीगंज
Daliya	दलिया
Dallaway	डॉलअवे
Dalli	दल्ली
Dalmau	डलमाउ
Dalmera	डलमेरा
Dalmia	डाल्मिया
Dalo	डालो
Dalpat	दल्पत
Dalsingh	दलसिंह
Daltonganj	डैल्टनगंज
Dalwi	दलवी
Damaris	डेमरिस
Damian	डैमियन
Damodar	दामोदर
Dan	डैन
Dan	दान
Dana	दाना
Danae	डेनी
Dances	डांसेस
Dancing	डांसिंग
Dandeli	डांडेली
Dandolo	दंडोलो
Dang	डंग
Danga	दंगा
Dangoaposi	डैंगोआपोसी
Daniel	डेनियल
Daniel	डैनियल
Danik	दैनिक
Danish	दानिश
Danone	डेनन
Danone	डैनॉन
Dante	दांते
Danube	डेन्यूब
Dappar	दापर
Dar	दार
Dara	दरा
Darabaar	दरबार
Daraganj	दरागंज
Darakhshaan	दरख्शान
Dararihan	दारारिहन
Darbhanga	दरभंगा
Dard	दर्द
Darin	डैरीन
Darius	डैरियस
Dariya	दरिया
Dark	डार्क
Darling	डार्लिंग
Darna	डरना
Darqawi	दरकावी
Darsh	दर्श
Darshan	दर्शन
Darshanaa	दर्शना
Dart	डार्ट
Daruka	दारुका
Darwin	डार्विन
Darya	दरया
Daryabad	दरियाबाद
Daryapur	दरियापुर
Daryll	डेरिल
Dasharath	दशरथ
Dasharh	दशरह
Dashehra	दशेरा
Dashiell	डैशीइल
Dashmesh	दशमेश
Dassault	डेसॉल्ट
Data	डेटा
Datamatics	डेटामेटिक्स
Daulat	दौलत
Daund	दौंड
Dauphin	डॉफिन
Daurai	दौराई
Davangere	दवांगेरे
Dave	दवे
Davidson	डेविडसन
Davis	डेविस
Dawlat	दवलत
Dawn	डाउन
Dayaanand	दयानंद
Dayakar	दयाकर
Dayanand	दयानंद
Dayanand	दयानन्द
Dayanita	दयनिता
Dayita	दयिता
Dayle	डायल
Days	डेज
Dayyan	दयान
Dazai	डजाई
Dazur	डेझूर
De	डे
De	दी
De	दे
Dea	डेया
Deakin	डीकिन
Deanne	डिएन
Debari	देबारी
Debashish	देबाशीश
Debasis	देबासिस
Debipur	देबीपुर
Debra	डेब्रा
Debu	देबू
Deccan	डेक्कन
Decker	डेकर
Dectron	डेक्ट्रॉन
Deepa	दिपा
Deepabali	दीपावली
Deepamala	दीपमाला
Deepaprabha	दीपप्रभा
Deepashikha	दीपशिखा
Deepen	दीपेन
Deepti	दीप्ति
Deeptiman	दीप्तिमान
Deeptimoyee	दीप्तिमोयी
Deevaan	दीवान
Deewan	दीवान
Deewangee	दीवानगी
Defiant	डिफायंट
Dehaj	देहज
Dehlo	देहलो
Deighton	डीघटन
Deiter	डेयटर
Dekho	देखो
Dekker	डेक्कर
Del	डेल
Del	देल
Delano	डेलेनो
Delbert	डेलबर्ट
Delia	डेलिया
Deliz	डेलिज
Dell	डैल
Delphine	डेल्फिन
Delta	डेल्टा
Delvada	देलवाडा
Demetra	डेमेट्रा
Demetrius	डिमेट्रियस
Denge	देंगे
Deniro	डीनिरो
Denis	डेनिस
Denman	डेनमन
Denness	डेनेस
Dennis	डेनिस
Deo	डियो
Deogan	देवगन
Deogarh	देवगड
Deonarine	देवनारायण
Deorakot	देवराकोट
Depinder	दीपिंदर
Dept	डेप्ट
Derawar	डेरावर
Derbacki	डेरबैकी
Derby	डेर्बी
Derick	डेरिक
Desai	देसाई
Desari	देसारी
Desdemona	डेस्डेमोना
Deshabimani	देशाबिमानी
Deshalpar	देशलपर
Deshmukh	देशमुख
Deshnok	देशनोक
Deshonnati	देशोन्नती
Desiree	डेसिरी
Desmond	डेस्मंड
Dessa	डेसा
Deswell	डेस्वेल
Detective	डिटेक्टिव
Detroit	डीट्रोएट
Detroj	देतरोज
Deulkar	देऊलकर
Deuskar	देऊसकर
Deutches	डचेस
Deutsche	डच
Deutscher	डेस्चर
Deux	ड्यूक्स
Devak	देवक
Devakottai	देवकोत्तई
Devamat	देवमत
Devanand	देवानन्द
Devar	देवर
Devaria	देवरिया
Devarsi	देवर्षि
Devavarya	देववर्य
Devdutta	देवदत्त
Devee	देवी
Developers	डेवलपर्स
Devhare	देवहरे
Devika	देविका
Devilal	देवीलाल
Deviprasad	देवीप्रसाद
Devnarayan	देवनारायण
Devon	डेवॉन
Devta	देवता
Dex	डेक्स
Dexter	डेक्स्टर
Dezso	देज्.
Dhaage	धागे
Dhaanesh	धानेश
Dhaarap	धारप
Dhaban	धबन
Dhadhria	ढढरीया
Dhadvaiwale	धडवईवाले
Dhaka	ढाका
Dhakiyah	धाकियाह
Dhaleshwari	धलेश्वरी
Dhaliwal	धालीवाल
Dham	धाम
Dhamaka	धमाका
Dhamangaon	धमनगांव
Dhami	धामी
Dhamija	धामीजा
Dhampur	धामपुर
Dhana	धना
Dhanawala	धनवाला
Dhandari	धंदारी
Dhandari	धानदरी
Dhande	धंधे
Dhandha	धंधा
Dhandhera	धंधेरा
Dhanesh	धनेश
Dhanmandal	धानमंडल
Dhanraj	धनराज
Dhansindi	धानसिंडी
Dhansukh	धनसुख
Dhanvant	धनवंत
Dhanvin	धनविन
Dhanwan	धनवान
Dhanya	धन्या
Dharampreet	धरमप्रीत
Dharangaon	धरनगाव
Dharanidhar	धरणिधर
Dharitri	धारित्रि
Dharmadas	धर्मदास
Dharmadev	धर्मदेव
Dharmapuri	धर्मपुरी
Dharmasena	धर्मसेना
Dharmatma	धर्मात्मा
Dharmavaram	धर्मवरम
Dharmendra	धर्मेंद्र
Dharmesh	धर्मेश
Dharmpur	धर्मपुर
Dharmveer	धर्मवीर
Dharnaoda	धरनौदा
Dhasa	धासा
Dhatri	धात्री
Dhaulpur	धौलपुर
Dhaura	धौरा
Dhavlikar	ढवलीकर
Dheeman	धीमन
Dheer	धीर
Dhekne	ढेकणे
Dhilwan	धिल्वान
Dhimaan	धीमान
Dhindhora	ढिंढोरा
Dhiraj	धीरज
Dhirganj	धीरगंज
Dhirpur	धीरपुर
Dhoban	धोबन
Dhoda	ढोडा
Dhodhar	धोधर
Dholka	ढोलका
Dhongee	ढोंगी
Dhot	ढोट
Dhruv	ध्रुव
Dhruva	ध्रुव
Dhul	धुल
Dhumravarn	धुम्रवर्ण
Dhupguri	धूपगुरी
Dhvani	ध्वनी
Di	डी
Di	दी
Dial	डायल
Diamantina	डायमेंटिना
Diamonds	डायमंड्स
Dianne	डाएन
Dianthe	डियांथ
Dibba	डिब्बा
Dibrugarh	डिब्रुगड
Dickens	डिकिन्स
Dickin	डिकिन
Diderot	डिडोरोट
Didjeridu	डिडजेरिदु
Didwana	डिडवाना
Diego	टियागो
Dierdra	डिएर्ड्रा
Digaru	दिगरु
Dighe	डिघे
Dighwara	दिघवारा
Digital	डिजीटल
Diksha	दीक्षा
Dikshapal	दिक्षपाल
Dil	दिल
Dilbar	दिलबर
Dilbari	दिलबरी
Dilber	दिलबर
Dildar	दिलदार
Dildarnagar	दिलदारनगर
Dillon	डिलन
Dillon	दिलो
Dilon	दिलों
Dilshan	दिलशान
Dimple	डिंपल
Dinakaran	दिनाकरण
Dindral	दिंदराल
Dingwahi	दिंगवाही
Dinhoy	दिनहोय
Dinkar	दिनकर
Dinos	डिनोस
Dionne	डियोन
Dionysus	डायोनिसस
Diphu	दिफु
Dippenaar	डिप्पेनार
Dirk	डिर्क
Dirt	डर्ट
Discus	डिस्कस
Disha	दिशा
Dishayen	दिशाये
Dishman	दिश्मन
Disque	डिस्क
District	डिस्ट्रिक्ट
District	डिस्ट्रीक्ट
Diti	दिति
Divan	दिवान
Divis	डिविस
Divorce	डीवोर्स
Divya	दिव्या
Divyesh	दिव्येश
Diwali	दिवाली
Diwali	दीवाली
Diwane	दीवाने
Diwar	दीवार
Dix	डिक्स
Dixie	डिक्सी
Dixit	दीक्षित
Dixon	डिक्सन
Diyodar	दियोधर
Dizi	डिजी
Djembe	डिजेम्बे
Dnieper	डॅनीपर
Dodballapur	डोडबलापुर
Dodda	डोडा
Dohak	दोहक
Dohara	दोहारा
Dohollah	दोहोल्लाह
Dolores	डोलोरेस
Dolti	डोलती
Dombivli	डोम्बिवली
Domingo	डॉमिन्गो
Domingo	डोमिंगो
Dominica	डोमिनिका
Dominy	डोमिनी
Domodedovo	डॉमोडेडोवो
Donagh	दोनघ
Donakonda	डोनाकोंडा
Donatella	डोनेटेला
Dongare	डोंगरे
Donigal	दोनीगल
Dooley	डूली
Doon	दून
Doonga	दूंगा
Dooriyan	दूरिया
Dora	डोरा
Dore	डोर
Dorel	डॉरेल
Dorey	डोरे
Dori	डोरी
Dorie	डोरी
Dorjan	डॉर्जन
Dosanjh	दोसांझ
Dostana	दोस्ताना
Dotty	डॉटी
Douaumont	डॉउमोंट
Double	डबल
Dougie	डौगी
Douglass	डगलस
Doulatpur	दौलतपुर
Dover	डॉवर
Dover	डोवर
Down	डाउन
Downing	डाउनिंग
Doyen	डोएन
Drayton	ड्राइटन
Dreadnought	ड्रेडनॉट
Dreiser	ड्रेजर
Drew	ज्रेव
Dristi	दृष्टि
Dronachellam	द्रोनाकेलम
Druce	ड्रयूस
Drugs	ड्रग्स
Druhin	द्रुहिन
Drum	ड्रम
Du	डु
Du	डू
Du	ड्यू
Duaba	दुआबा
Duane	ड्यूएन
Dubrovnik	डब्रोवनिक
Dudh	दुध
Dudhwakhara	दुधवाखरा
Duers	डुअर्स
Duf	डफ
Duff	डफ
Duffin	डफिन
Dugan	ड्यूगन
Duganpur	दुगनपुर
Duhai	दुहाई
Dujon	डुजोन
Dulcina	डल्सिना
Dulhan	दुल्हन
Dulhe	दूल्हे
Dumoga	डूमोगा
Dumraon	दुमराव
Dundwara	दुंदवाडा
Duniya	दुनिया
Duniyadari	दुनियादारी
Dupage	ड्यूपेज
Duperre	ड्यूपेरे
Duquesne	ड्यूक्वेस्न
Duraundha	दुरौंधा
Durgaaprasaad	दुर्गाप्रसाद
Durgapur	दुर्गापुर
Durgapura	दुर्गापुरा
Durgauti	दुर्गौती
Durgesh	दुर्गेश
Durham	डरहैम
Durrani	दुर्रानी
Durvish	दुर्विश
Dus	दस
Dusanjh	दुसांझ
Dushman	दुश्मन
Dushmani	दुश्मनी
Dushmanon	दुश्मनो
Dushyanta	दुष्यंत
Duty	ड्यूटी
Duvvada	दववाडा
Dvijavahan	द्विजवाहन
Dwaipayan	द्वैपायन
Dwarkadhish	द्वारकाधीश
Dwijaraj	द्विजराज
Dwijendra	द्विजेंद्र
Dyani	डाएनी
Dyani	दयानी
Dyer	डायर
Dyes	डाइज
Dylan	डिलेन
Dynamics	डायनामिक्स
Dyson	डायसन
E	इ
Eadoin	ईडोइन
Eara	ईरा
Earlene	ईयरलेन
Earnest	अर्नेस्ट
Earth	अर्थ
Easau	ईसो
Easter	ईस्टर
Eastland	ईस्टलैंड
Ebrahim	एब्राहिम
Ecchumati	इच्छुमती
Echo	इको
Economic	इकनॉमिक
Ed	एड
Edabali	इदाब्ली
Edan	ईडन
Edana	एडना
Edeline	एडलिन
Edi	एडी
Edie	एडी
Edinburg	एडिनबर्ग
Edith	एडिथ
Edmonton	एडमॉन्टन
Edmund	एडमंड
Edric	एड्रिक
Eesaa	ईसा
Effingham	एफिंघम
Egan	एगन
Egebergs	एजबर्ग्स
Ehren	एहरेन
Ehsanul	एहसानुल
Ehtiram	एहतिराम
Eifel	एइफेल
Einsteinium	आइंस्टिनियम
Eisner	ईस्नर
Ejaz	एजाज
Ekachakra	एकचक्र
Ekalinga	एकलिंग
Ekanath	एकनाथ
Ekata	एकता
Ekatan	एकतन
Ekjot	एकजोत
Eksteen	एक्सटीन
Ekteshwar	एकटेश्वर
El	अल
El	एल
Elahi	इलाही
Elaine	एलेना
Elani	इलेनी
Elburz	एल्बुर्ज
Elda	एल्डा
Elden	एल्डन
Eldine	एल्डिन
Eleanor	एलिएनर
Eleanor	एलिएनॉर
Electirc	इलेक्ट्रिक
Electric	इलेक्टिक
Electric	इलेक्ट्रिक
Electrolux	इलेक्ट्रोलक्स
Electronics	इलेक्ट्रॉनिक्स
Electrosteel	इलेक्ट्रोस्टील
Elephant	एलिफंट
Elephant	एलिफेंट
Elfat	इलफत
Elgi	एल्जी
Elisa	एलिसा
Elise	एलिस
Elita	एलिटा
Elizabeth	एलीजाबेथ
Elkhorn	एल्कहॉर्न
Elle	एलीन
Ellesmere	एलेस्मेरे
Ellie	एली
Elliott	इलियोट
Ellison	एलिसन
Elron	एलरॉन
Elroy	एलरॉय
Eltek	एल्टेक
Elworthy	एल्वर्दी
Elwyn	एल्विन
Elxsi	एल्क्सी
Elyas	इलियास
Emanuele	इमानुएल
Emas	इमस
Emberlynn	एम्बरलीन
Embourg	एम्बॉर्ग
Emelda	इमेल्डा
Emery	एमेरी
Emil	एमिल
Emilie	एमिली
Emir	एमिर
Emira	एमिरा
Emperor	एम्परर
Empire	एंपायर
Emre	इमर
Enakshi	ईनाक्षी
Enamul	एनामुल
Endeavour	एण्डएवर
Energy	एनर्जी
Engel	एंजेल
Engine	इंजिन
Engineersind	इंजीनियर्सइंड
Engines	इंजिन्स
Enid	एनिड
Enrico	एनरिको
Enter	एन्टर
Enterprise	एंटरप्राइज
Entertainment	एंटरटेनमेंट
Environnement	एनवायरमेंट
Episcopal	एपिस्कोपाल
Equipments	इक्विपमेंट्स
Erie	एरी
Erimentha	एरिमेंथा
Erma	एर्मा
Ermina	एर्मिना
Ernakulam	इरनाकुलम
Ernesettle	अर्नसेटल
Ernie	एर्नी
Erno	एर्नो
Eros	ईरोज
Errol	एरॉल
Errol	एरोल
Esam	इसाम
Escorts	एस्कॉर्ट्स
Eskalis	ऐसकालिस
Esmeralda	एस्मरेल्डा
Essel	एस्सेल
Esser	एसर
Essex	एसेक्स
Establishment	एस्टैबलिशमेंट
Ester	एस्टर
Etalan	इटलन
Ethanael	एथनील
Ethiopian	इथियोपियन
Etta	एट्‍टा
Ettumanoor	एट्टुमान्नूर
Euclid	यूक्लिड
Eudora	इयूडोरा
Eudora	यूडोरा
Eugen	यूगेन
Eulalia	यूलेलिया
Eulalie	यूलेली
Euro	यूरो
Europa	यूरोपा
Eustacia	यूस्टेसिया
Evangelia	इवेंजेलिया
Evangelist	एव्हनगेलिस्ट
Evania	इवानिया
Evans	इवेन्स
Evans	ईवंस
Evanthe	इवांथ
Evelia	इवेलिया
Evelyn	इवेलिन
Evening	ईवनिंग
Everest	एवरेस्ट
Evergreen	एवरग्रीन
Everley	एवरली
Everton	एवर्टन
Evertsen	एवर्टसेन
Ewan	इवान
Ewing	एविंग
Excel	एक्सेल
Excelsior	एक्ससेलसीयर
Exceptional	एक्सेप्शनल
Exide	एक्साइड
Explorer	एक्सप्लोरर
Exupery	एक्सुपेरी
Eyab	एयब
Eydie	ईदी
Eyre	येरी
Faakhruddin	फकरूद्दीन
Faasle	फासले
Fabian	फैबियन
Fabiano	फैबियानो
Fabrizio	फैब्रिजियो
Face	फेस
Fadil	फादील
Fado	फेडो
Faeq	फाएक
Faheemah	फहीमाह
Faidah	फैदाह
Faiq	फैक
Faiqah	फैकाह
Faiz	फैज
Faizani	फैजानी
Faizi	फ़ैजी
Fajr	फज्र
Fajyaz	फैजयाज
Fakeehah	फकीहाह
Fakhirah	फखीराह
Fakhr	फख्र
Fakhrabad	फख्राबाद
Fakhtah	फख्ताह
Fakihah	फकीहाह
Falah	फलाह
Falahi	फलाही
Falakata	फलकाता
Falaq	फलक
Falewal	फलेवाल
Fallon	फैलन
Falls	फॉल्स
Fame	फेम
Fanie	फैनी
Faolan	फाओलेन
Faoud	फाउड
Faqeeh	फकीह
Faqir	फकीर
Farah	फराह
Farhad	फरहाद
Farhan	फरहान
Farhanah	फरहाना
Farhedi	फरहेदी
Faridah	फरीदाह
Farihah	फरीहाह
Farishte	फरिश्ते
Farlington	फार्लिंगटन
Farm	फार्म
Farmaish	फरमाइश
Farman	फरमान
Farrah	फराह
Farrakhan	फराखान
Farrell	फैरेल
Faruca	फरूका
Farwah	फरवाह
Fasad	फसाद
Fasal	फसल
Faseelah	फसीलाह
Fashion	फैशन
Fatah	फतह
Fatarfod	फातरफोड़
Fatehnagar	फतेहनगर
Fatherland	फादरलैंड
Fathom	फैथम
Fatik	फतिक
Fatima	फातिमा
Fatinah	फतिनाह
Fatowali	फतोवाली
Fattanwala	फत्तणवाला
Fauji	फौजी
Fauladi	फौलादी
Faunia	फॉनिया
Fausta	फॉस्टा
Faustus	फॉस्टस
Fawiza	फविजा
Faylinn	फेलिन
Fayyadh	फय्याद
Fazalpur	फजलपुर
Fdederated	फेडरेटेड
Federal	फेडेरल
Feerozah	फीरोजाह
Feinstein	फेनस्टिन
Felipe	फेलीप
Felis	फिलीस
Felton	फेल्टन
Femina	फेमिना
Feoras	फेओरस
Fer	फर
Ferdinand	फर्डिनांड
Ferdinand	फर्डीनांद
Fergal	फेर्गल
Fergus	फेर्गस
Ferguson	फरग्यूसन
Ferguson	फर्गुसन
Ferid	फेरीड
Fermi	फर्मी
Fern	फर्न
Ferok	फेरोक
Ferrol	फेरोल
Ferry	फेरी
Fert	फर्ट
Fertilisers	फर्टीलाइजर्स
Fertliser	फर्टीलाइजर
Festung	फेस्टंग
Fiat	फिएट
Fida	फिदा
Fiddah	फिदाह
Fiddle	फिडल
Fidella	फिडेला
Field	फील्ड
Fielding	फील्डिंग
Fields	फील्ड्स
Fifi	फिफी
Filght	फ्लाइट
Filia	फिलिया
Filiberto	फिलिबर्टो
Filler	फिल्लर
Film	फिल्म
Financial	फाइनेंशियल
Financial	फायनैन्शियल
Financiero	फाइनेंशिएरो
Fine	फाइन
Finnea	फीनिया
Fionnuala	फियोन्यूएला
Fionnula	फियोन्नूला
Fiorella	फियोरेला
Fipple	फिप्पल
Firas	फिरास
Firdausi	फिरदौसी
Firdaws	फिरदौस
Firebrand	फायरब्रांड
Firoza	फीरोजा
Firozabad	फिरोजाबाद
Firozpur	फिरोजपुर
First	फर्स्ट
Fischer	फिशर
Fisher	फिशर
Fisk	फिस्क
Fitzwilliam	फिट्जविलियम
Five	फाइव
Flamel	फ्लेमल
Flandre	फ्लेंडर
Flann	फ्लान
Flavian	फ्लेवियन
Fleck	फ्लेक
Fleming	फ्लेमिंग
Fleur	फ्लेउर
Flextronics	फ्लेक्सट्रॉनिक्स
Flint	फ्लिंट
Florence	फ्लोरेंस
Floria	फ्लोरीया
Florrie	फ्लोरी
Flourochem	फ्लोरोकेम
Flower	फ्लार
Flower	फ्लावर
Flutes	फ्ल्यूट्स
Fly	फ्लाय
Flying	फ्लाइंग
Foch	फॉक
Foi	फोई
Folklore	फोकलोर
Fonda	फोंडा
Foods	फूड्स
Foolasinh	फूलसिंह
Foolendu	फूलेंदु
For	फॉर
Force	फोर्स
Ford	फोर्ड
Fordon	फोर्डन
Forest	फॉरेस्ट
Forever	फॉरएवर
Forge	फॉर्ज
Forge	फोर्ज
Formidable	फोर्मिडेबल
Forrestal	फॉरेस्टल
Forster	फॉर्स्टर
Fortaleza	फोर्टालेजा
Fortress	फोट्रेस
Fortress	फोर्टरेस
Fortress	फोर्ट्रेस
Forts	फोर्ट
Forts	फोर्ट्स
Fossil	फॉसिल
Fossilized	फॉसिलाइज्ड
Foudre	फॉडर
Foundation	फाउंडेशन
Four	फोर
Fowler	फॉलर
Foy	फोय
Fram	फ्रैम
Fran	फ्रान
Franc	फ्रैंक
Frances	फ्रांसिस
Francesco	फ्रांसेस्को
Francois	फ्रान्सीस
Francois	फ्रेंकोइस
Frankfurt	फ्रेंकफर्ट
Franks	फ्रैंक्स
Fransisco	फ्रांसिस्को
Fraser	फ्रेजर
Fraser	फ्रेसिर
Freddy	फ्रेडी
Fredericks	फ्रेडरिक्स
Free	फ्री
Freer	फ्रीर
Freeseas	फ्रीसीज
Freestone	फ्रीस्टोन
Freestyle	फ्रीस्टाइल
Freiburg	फ्रेइबर्ग
Fresno	फ्रेस्नो
Freud	फ़्रुड
Frick	फ्रिक
Friedan	फ्रिडन
Friedland	फ्रेडलैंड
Friendship	फ्रेंडशिप
Fuel	फ़्यूल
Fuji	फूजी
Fulghum	फल्घम
Fulki	फुलकी
Fuller	फुलर
Funtoosh	फंटूश
Furayah	फरायाह
Furkating	फर्कटिंग
Furqan	फु़र्कान
Future	फ्युचर
Future	फ्यूचर
Futuremedia	फ्यूचरमीडिया
Futures	फ्युचर्स
Fynn	फिन
Gaadi	गाडी
Gaandeevadhaaree	गांदीवधारी
Gaawdi	गावडी
Gaayatree	गायत्री
Gaban	गबन
Gabriel	गैब्रियल
Gachhipura	गच्चीपुरा
Gaddar	गद्दार
Gaddu	गड्डु
Gadgil	गाडगिल
Gadha	गधा
Gadolinium	गैडोलीनियम
Gadulka	गडुल्का
Gadwal	गड़वाल
Gaenor	गायनोर
Gaetan	गैटन
Gaetano	गैटेनो
Gafoor	गफूर
Gagel	गैगल
Gagroli	गगरोली
Gaidhani	गायधनी
Gaines	गेन्स
Gainjahwa	गैनजहवा
Gainsari	गैनसारी
Gaipura	गायपुरा
Gaius	गैउस
Gajadant	गजदंत
Gajanand	गजानन्द
Gajare	गाजरे
Gajavaan	गजवान
Gajraula	गजरौला
Gajre	गजरे
Gala	गाला
Galaxy	गैलक्सी
Galaxy	गैलेक्सी
Gale	गले
Gale	गाले
Gali	गली
Galiena	गेलिएना
Galilei	गैलीली
Galiyan	गलिया
Gallagher	गैलेगर
Galleries	गैलरीज
Gallop	गैलप
Galva	गल्वा
Gam	गम
Gaman	गमन
Gamini	जेमिनी
Gamma	गामा
Gammon	गैमॉन
Ganaraj	गणराज
Ganashakti	गणशक्ति
Gandhali	गांधाली
Gandharin	गांधारिन
Gandharva	गंधर्व
Gandhidham	गांधीधाम
Gandhinagar	गांधीनगर
Ganee	गनी
Ganeshvar	गणेश्वर
Ganga	गंगा
Gangaa	गंगा
Gangaaraam	गंगाराम
Gangadhar	गंगाधर
Gangakher	गंगाखेर
Gangapur	गंगापुर
Gange	गंगे
Gangesh	गंगेश
Gangian	गांगिया
Gangrar	गंग्रार
Gangtok	गंगटोक
Gangu	गंगू
Ganguly	गांगुली
Ganj	गंज
Ganjam	गंजम
Ganjmuradabad	गंजमुरादाबाद
Ganjshakar	गंजशाकर
Ganwar	गवार
Gaon	गाव
Gaoo	गउ
Gap	गैप
Garci	गॉर्की
Garcia	गर्शिया
Garden	गार्डन
Gareth	गेरेथ
Garewal	गरेवाल
Garh	गढ
Garhwa	गढवा
Garibi	गरीबी
Garibon	गरीबो
Gariep	गेरीप
Garjana	गर्जना
Garma	गरमा
Garments	गारमेंट्स
Garot	गरोट
Garrett	गैरेट
Garrick	गैरिक
Garry	गेरी
Garuda	गरुड
Garwa	गरवा
Gasbah	गस्बाह
Gasconade	गैस्कोनेड
Gaskin	गैस्किन
Gatana	गटाना
Gates	गेट्स
Gaulle	गौले
Gauloise	गॉलोइस
Gaura	गौरा
Gauri	गौरी
Gaurinath	गौरीनाथ
Gautier	गॉतियर
Gavotte	गैवोट
Gawaahi	गवाही
Gawarikar	गवारीकर
Gaya	गया
Gayda	गयदा
Gazalee	गजली
Gazelle	गैज़ेली
Gears	गियर्स
Gede	गेडे
Gediminas	गेडिमिनास
Geet	गीत
Gellert	गेलर्ट
Gemma	गेमा
Genco	जेन्को
General	जनरल
Generals	जनरल्स
Genetic	जेनेटिक
Geneva	जेनेवा
Genevieve	जेनेवीव
Gent	गेंट
Gentium	जेन्टियम
Gentleman	जेंटलमैन
Geoffrey	जिओफ्रेय
Geometric	जिओमेट्रिक
Geometry	ज्योमेट्री
Geordi	गेओर्डी
Georges	जॉर्ज
Georges	जॉर्ज्स
Georgette	जॉर्जेट
Georgian	जॉर्जियन
Georgianna	जार्जियाना
Geraint	गेरैंट
Gerais	गेरैस
Gerard	गेरार्ड
Germain	जर्मेन
German	जर्मन
Germany	जर्मनी
Germon	जर्मन
Gerodi	गेरोडी
Geronimo	गेरोनिमो
Gesco	गेस्को
Getey	गेटे
Ghabrahat	घबराहट
Ghadi	घडी
Ghadir	गादिर
Ghagghar	घग्घर
Ghaib	घइब
Ghaisas	घैसास
Ghalib	गालीब
Ghaliyah	गलीयाह
Ghalodi	घलोडी
Ghamandee	घमंडी
Ghanauli	घनौली
Ghaniyah	गनियाह
Ghannam	घन्नाम
Ghantal	घंटाल
Ghante	घंटे
Ghar	घर
Gharpure	घारपुरे
Gharwali	घरवाली
Ghaso	घासो
Ghata	घटा
Ghataka	घटाका
Ghatampur	घातमपुर
Ghatna	घंटा
Ghatsila	घाटसिला
Ghauri	घौरी
Ghavri	घावरी
Ghayda	गायदा
Ghazab	गजब
Ghazipur	गाजीपुर
Ghita	गीता
Ghitbah	गीत्बाह
Ghodgaonkar	घोडगावकर
Ghugi	घुगी
Ghulam	गुलाम
Ghumar	घूमर
Ghunghat	घूंघट
Ghuri	घूरी
Giancarlo	गियानकार्लो
Gibbs	गिब्स
Gibraltar	जिब्राल्टर
Giddh	गिद्ध
Gidhaur	गिधौर
Gigi	गिगी
Gijare	गिजरे
Gilani	गिलानी
Gilda	गिल्डा
Gilkicker	गिलकिकर
Giller	गिलर
Gillette	जिलेट
Gillian	गिल्लिअन
Gilmour	गिल्मॉर
Gilo	गिलो
Gina	जीना
Ginata	जीनाटा
Ginny	जिनी
Ginny	जीनी
Ginsberg	गिंसबर्ग
Giovanni	जियोवान्नी
Gir	गीर
Gira	गिरा
Giraftaar	गिरफ्तार
Giran	गिरन
Girdhar	गिरधर
Girgala	गिरगाला
Giri	गिरि
Girija	गिरिजा
Girik	गिरिक
Girilal	गिरिलाल
Giripati	गिरिपती
Girish	गिरीश
Girl	गर्ल
Girna	गिर्ना
Girwar	गिरवार
Gitanjali	गीतांजलि
Gitano	गिटेनो
Giulia	गिउलिआ
Giuliani	ज्युलयानी
Given	गीवन
Giverny	गिवेर्नी
Gizela	गिझेला
Glacier	ग्लेशियर
Gladstone	ग्लैडस्टोन
Glain	ग्लैन
Glasgow	ग्लासगो
Glasgow	ग्लैसगॉ
Glasgow	ग्लैसगो
Glass	ग्लास
Glenmark	ग्लैनमार्क
Glenyon	ग्लेन्यॉन
Glenys	ग्लेनिस
Glomar	ग्लोमर
Glora	ग्लोरा
Gloria	ग्लोरिया
Gloriann	ग्लोरियन
Gloucestershire	ग्लॉसेस्टरशायर
Glove	ग्लोव
Glycols	ग्लायकॉल्स
Glynn	ग्लिन
Glynnis	ग्लिनिस
Goa	गोवा
Goalpara	गोलपारा
Gobain	गॉबेन
Gobain	गॉबैन
Gobi	गोबी
Godaa	गोदा
Godaavaree	गोदावरी
Goddard	गोडार्ड
Godhuli	गोधुली
Godiva	गॉडिवा
Gods	गॉड्स
Goetze	गोएट्ज
Gogh	गोह
Gogia	गोगिया
Gokcen	गॉकेन
Gol	गोल
Golaghat	गोलाघाट
Golanthra	गोलंथरा
Golda	गोल्डा
Goldberg	गोल्डबर्ग
Golden	गोल्डन
Goldene	गोल्डन
Goldie	गोल्डी
Goldy	गोल्डी
Gole	गोले
Goli	गोली
Goliath	गोलीअथ
Goljamata	गोल्जामाटा
Gomati	गोमती
Gomer	गोमर
Gomes	गोम्स
Gomoh	गोमोह
Gompa	गोम्पा
Gomti	गोमती
Gondia	गोंदिया
Goneana	गोनीएना
Goodhue	गुडह्यू
Goodrum	गूडरुम
Gooty	गूटी
Gopalpur	गोपालपुर
Gopan	गोपन
Gopati	गोपती
Gopesh	गोपेश
Gopi	गोपी
Gopikrushna	गोपीकृष्ण
Gopinath	गोपीनाथ
Goram	गोरम
Gorana	गोराना
Goraya	गोराया
Goregaon	गोरेगांव
Gorge	गॉर्ज
Gorila	गोरीला
Gorilla	गोरीला
Goriyan	गोरियान
Gosavi	गोसावी
Goshainganj	गोशैनगंज
Goti	गोटी
Goudy	गॉडी
Gough	गॉघ
Goulandris	गॉलैंड्रीस
Gould	गुल्ड
Goverdhan	गोवर्धन
Governor	गवर्नर
Govinda	गोविंदा
Govinda	गोविन्दा
Govindaraja	गोविंदराजा
Gower	गॉवर
Grady	ग्रेडी
Grah	ग्रह
Gramophone	ग्रामोफोन
Gran	ग्रान
Granth	ग्रंथ
Graphics	ग्राफिक्स
Grasslands	ग्रासलैंड
Gratiana	ग्रेटिएना
Gratiot	ग्रेटियोट
Greatbatch	ग्रेटबैच
Greave	ग्रीव
Greece	ग्रीस
Greening	ग्रीनिंग
Greenland	ग्रीनलैंड
Greenspan	ग्रीनस्पान
Greg	ग्रेग
Grey	ग्रे
Gridco	ग्रिडको
Grihasti	गृहस्थी
Grimes	ग्रिम्स
Griselda	ग्रिसेल्डा
Grishma	ग्रीष्म
Gros	ग्रोस
Groucho	ग्रोउको
Groupe	ग्रुप
Grover	ग्रोवर
Grumman	ग्रुम्मन
Grundy	ग्रंडी
Grupo	ग्रुपो
Grutas	ग्रुटस
Gryta	ग्रीटा
Gua	गुआ
Guardian	गार्डियन
Guddi	गुड्डी
Gudiyattam	गुडियात्तम
Gudur	गुदुर
Guenevere	गुएनवेर
Gufic	गुफिक
Gugor	गुगोर
Guide	गाइड
Guilder	गिल्डर
Guimaraes	गुइमाराइस
Guinevere	गुइनवेर
Gujjar	गुज्जर
Gujri	गुजरी
Gulabhganj	गुलाबगंज
Guljar	गुल्जार
Gullpur	गुल्लपूर
Gulshan	गुलशन
Gulzar	गुलजार
Gumasta	गुमास्ता
Gumla	गुमला
Gumrah	गुमराह
Gumwant	गुणवंत
Gunah	गुनाह
Gunahon	गुनाहो
Gunawardene	गुणवर्दने
Gunda	गुंडा
Gundappa	गुंडप्पा
Gundar	गुन्दर
Gundaraj	गुंडाराज
Gunjati	गुंजती
Guntakal	गुन्टाकल
Gunther	गुंथर
Gunung	गुनुंग
Gunwanti	गुणवंती
Guoqin	ग्योकिन
Guraia	गुरइया
Guraru	गुरारु
Gurdaspur	गुरदासपुर
Gurdjieff	गुर्डजिफ
Gurhi	गुर्ही
Guriqbal	गुरीकबाल
Gurjeet	गुरजीत
Gurjinder	गुरजिंदर
Gurla	गुर्ला
Gursagar	गुरसागर
Gursahaiganj	गुरसहायगंज
Gursharan	गुरशरण
Gurudwara	गुरूद्वारा
Guruvayur	गुरुवयूर
Gussa	गुस्सा
Guzara	गुजारा
Gwenifer	ग्वेनिफर
Gwinetts	ग्विंट्टस
Gwydion	ग्वीडियन
Gwylan	ग्वायलेन
Gyaanadev	ज्ञानदेव
Gyalshing	ग्यालशिंग
Gyanada	ज्ञानदा
Gyandev	ज्ञानदेव
Gyaneshwari	ज्ञानेश्वरी
Gyarah	ग्यारह
Gydan	ग्यदान
Gyula	ग्यूला
Haadsa	हादसा
Haara	हारा
Haasaa	हासा
Haath	हाथ
Hababah	हबबाह
Habeeba	हबीबा
Hadeeqah	हदीकाह
Hadiyah	हदियाह
Hadlee	हेडली
Hadlee	हैडली
Haesdonck	हेसडॉन्क
Hafez	हफेज
Hafi	हाफी
Hafizah	हफीजाह
Hai	हाई
Hai	है
Haider	हैदर
Hailakandi	हैलाकांडी
Haim	हैम
Haimavat	हैमवत
Haimvat	हैमवत
Haiwan	हैवान
Hajar	हजर
Hajgiri	हजगिरी
Hajib	हजीब
Hajjaj	हज्जाज
Hajji	हाजी
Hajna	हज्ना
Hajrah	हजराह
Hakeem	हकीम
Halah	हलाह
Halaku	हलाकू
Haldia	हल्दीया
Haleef	हलीफ
Halers	हैलर्स
Halifax	हैलिफैक्स
Hallaj	हल्लाज
Halwara	हल्वारा
Halwarvi	हलवार्वी
Hamare	हमारे
Hamari	हमारी
Hamas	हमास
Hamburg	हैमबर्ग
Hamburg	हैम्बर्ग
Hamdard	हमदर्द
Hami	हामी
Hamid	हमीद
Hamid	हामिद
Hamidieh	हैमीडीह
Hamish	हमीश
Hamjolee	हमजोली
Hammond	हैमॉण्ड
Hampton	हैंप्टन
Hamzah	हमजाह
Hamzah	हम्जाह
Hanarotelecom	हेनेरोटेलीकॉम
Hands	हैंड्स
Haniel	हेनीयल
Hanifah	हनीफाह
Hannah	हन्नाह
Hannan	हन्नान
Hans	हंस
Hans	हॅन्स
Hans	हैन्स
Hanso	हंसो
Haq	हक
Haqeeqat	हकीकत
Haque	हक
Haque	हॉक
Harad	हरड
Harasharan	हरशरण
Harbhajan	हरभजन
Hardy	हार्डी
Haree	हरी
Harendra	हरेन्द्र
Harfan	हरफन
Hari	हरी
Haridwar	हरिद्वार
Harimandir	हरिमंदिर
Harinarayan	हरीनारायण
Harindar	हरिन्दर
Harinder	हरिन्दर
Harishankar	हरिशंकर
Harishchndra	हरिश्चंद्र
Harisingar	हरिसिंगार
Hariy	हरिय
Hariyali	हरियाली
Harmison	हर्मीसन
Harmonium	हारमोनियम
Harnett	हार्नेट
Harold	हेरोल्ड
Harpertzoon	हैपर्टजून
Harrison	हरिसॉन
Harsaru	हरसारु
Harshad	हर्षत
Harshe	हर्षे
Hart	हार्ट
Hartland	हार्टलैंड
Harun	हारून
Harunur	हरुनर
Harvinder	हरविंदर
Harvy	हार्वी
Harz	हार्ज
Hasan	हसन
Haseen	हसीन
Hashan	हशन
Hashid	हशीद
Hashir	हशीर
Hashmat	हशमत
Hasib	हसीब
Hasibul	हसिबुल
Hasino	हसीनो
Haslam	हेसलम
Hassium	हैशियम
Hat	हैट
Hatheli	हथेली
Hathi	हाथी
Hathras	हाथरस
Hatya	हत्या
Hatyara	हत्यारा
Haun	हॉन
Havalimani	हवालीमनी
Havana	हवाना
Havas	हवस
Haven	हेवन
Hawaii	हवाई
Hawaiian	हवाई
Hawalat	हवालात
Hawaldar	हवलदार
Hawas	हवस
Haweliana	हवेलियाना
Hawk	हॉक
Hawkins	हॉकिन्स
Hawthornden	हॉथोर्नडेन
Hayaat	हयात
Hayah	हयाह
Hayden	हेडन
Hayes	हेस
Hayo	हेयो
Hazaribagh	हजारीबाग
Head	हेड
Headley	हेडले
Healy	हीलि
Hearst	हर्स्ट
Heath	हीथ
Heavy	हेवी
Heckenberg	हेकनबर्ग
Hedgewar	हेडगेवार
Heemskerck	हीम्सकर्क
Heer	हीर
Heera	हीरा
Hein	हेन
Heineken	हेंकेन
Heineman	हेनमैन
Helen	हेलन
Helen	हेलेन
Helens	हेलेन्स
Hemant	हेमंत
Hemantha	हेमंथा
Hemaraj	हेमराज
Hemingway	हेमिंग्वे
Hemis	हेमीस
Hempstead	हेम्पस्टेड
Hemraaj	हेमराज
Hemraj	हेमराज
Henderson	हेंडरसन
Hendricks	हैंड्रिक्स
Hendrik	हेन्ड्रिक
Hendy	हेंडी
Henly	हेनली
Hepburn	हेपबर्न
Herald	हेराल्ड
Hercules	हरक्युलस
Heriot	हेरीओट
Heriot	हैरियट
Heritage	हेरिटेज
Heroism	हीरोइज्म
Herschelle	हरशेले
Hertfordshire	हर्टफोर्डशायर
Hertog	हर्टोग
Hessell	हेसेल
Heston	हेस्टोन
Hewlett	ह्यूलेट
Hibah	हिबाह
Hibatullah	हिबातुल्लाह
Hibernia	हिबर्निया
Hibiscus	हिबिस्क्स
Hick	हिक
Hickory	हिकॉरी
Hidalgo	हिडाल्गो
Hidayat	हिदायत
Higgins	हिगिंस
Higgs	हिग्स
Highveld	हाईवेल्ड
Hiking	हाइकिंग
Hillard	हिल्लर्ड
Hillary	हिलेरी
Hillier	हिलीयर
Hills	हिल्स
Himaalay	हिमालय
Himaanee	हिमानी
Himalay	हिमालय
Himalaya	हिमालय
Himatsingka	हिमतसिंगका
Himmat	हिम्मत
Hin	हिन
Hindalco	हिंडाल्को
Hindi	हिन्दी
Hindu	हिन्दु
Hindu	हिन्दू
Hindustaanee	हिंदुस्तानी
Hindvee	हिंदवी
Hinge	हिंगे
Hirakud	हीराकुड
Hirve	हिरवे
Hisar	हिसार
Historical	हिस्टॉरिकल
Hite	हिटे
Hitesh	हितेश
Hitler	हिटलर
Hizen	हाइजन
Hobey	होबी
Hoche	हॉक
Hockey	हॉकी
Hodge	हॉज
Hoffman	हॉफमन
Hogan	हॉगन
Hoggard	हॉगर्ड
Holding	होल्डिंग
Holland	हॉलैंड
Hollogne	हॉलोगने
Holly	हॉली
Holmium	हॉल्मियम
Holy	होली
Home	होम
Homme	होम
Hondo	होंडो
Honeywell	हनीवेल
Hong	होंग
Honorary	ऑनररी
Honour	हॉनर
Honswijk	हॉन्सविज्क
Hoo	हू
Hook	हुक
Hooper	हूपर
Hope	होप
Hopkins	हॉपकिन्स
Hopwood	हॉपवुड
Horatio	होराशियो
Horeshoes	हॉरशूज़
Horizon	हॉरीझोन
Horizon	होरिझोन
Horn	हॉर्न
Horne	होर्न
Hornet	होर्नेट
Horny	हॉर्नी
Horse	होर्स
Hosho	होशो
Hospital	हॉस्पिटल
Hossein	हुसैन
Hostel	होस्टल
Hote	होते
Hotel	होटेल
Hotels	हॉटेल्स
Hothi	होठी
Hoti	होटी
Houghton	हॉटन
How	हॉ
Howard	हॉवर्ड
Howarth	हॉवर्थ
Howe	हॉवे
Howrah	हावडा
Hrishikesh	ऋषिकेश
Hua	हुआ
Hubayshah	हुबायशाह
Hubba	हब्बा
Huge	ह्यूज
Hujayyah	हुजय्याह
Hukum	हुकुम
Hula	हुला
Hulla	हल्ला
Huma	हुमा
Humam	हमाम
Humare	हमारे
Humaydah	हुमयदाह
Humboldt	हमबोल्ट
Humdum	हमदम
Humkadam	हमकदम
Hummingbird	हमिंगबर्ड
Humor	ह्युमर
Humphrey	हम्फ्री
Humraaz	हमराज
Hungary	हंगरी
Hunterian	हंटेरियन
Huntsville	हन्ट्सविले
Hurayth	हुरायथ
Hurley	हरले
Hurrey	हुर्रे
Hurst	हर्स्ट
Husam	हुसम
Husna	हुस्ना
Husnaa	हुस्ना
Husnaara	हुस्नआरा
Husnara	हुस्नआरा
Husnaraa	हुस्नआरा
Husnee	हुस्नी
Hussein	हुसैन
Hussey	हस्से
Huzoor	हुजूर
Hyderabad	हैदराबाद
Hydrogen	हाइड्रोजन
Iago	इयागो
Iain	इयान
Ian	इआन
Ianna	इयन्ना
Iberdrola	ईबरड्रोला
Iberian	इबेरीयन
Ibhanan	इभानन
Ibiza	इबिजा
Ibn	इब्न
Ibrat	इबरत
Ibthaj	इब्थज
Iceland	आइसलैंड
Idalee	इडली
Idd	ईद
Idi	इदी
Idjwi	इड्ज्वी
Idola	इडोला
Idries	इड्रीस
Idris	इदरिस
Iduki	इडुकी
Ifflis	लिफलिस
Iflex	आयफ्लेक्स
Ihsan	इहसान
Ijli	इजली
Ikabaal	इकबाल
Iki	इकी
Ikka	इक्का
Ikram	इकराम
Ilaaka	इलाका
Ilaaka	इलाकी
Ilandere	इलेन्डर
Ilesh	इलेश
Ilifat	इलिफात
Ilithya	इलिथिया
Illingworth	इलिंगवर्थ
Illingworth	इलिंगवॉर्थ
Ilse	इल्सी
Ilzaam	इल्जाम
Imaandar	ईमानदार
Imaging	इमेजिंग
Imam	इमाम
Imarat	इमारत
Imogene	इमोजेन
Impenetrable	इम्पेनेट्रेबल
Implacable	इमप्लेसेबल
Imtihal	इम्तिहाल
Imtiyaz	इम्तियाज
In	इन
Ina	इना
Incorporated	इंकॉर्पोरेटेड
Incorporated	इनकॉर्पोरेटेड
Incorporated	इन्कॉर्पोरेटेड
Incredimail	इंक्रेडिमेल
Ind	इंडस्ट्रीज
Ind	इंडियन
Indefatigable	इंडिफेटिजेबल
Indemnity	इंडिम्निटी
Inderjit	इंदरजीत
India	इंडिया
Indiana	इंडिएना
Indiana	इंडियाना
Indika	इंडिका
Indira	इंदिरा
Indira	इन्दिरा
Indirapuram	इंदिरापुरम
Indium	इंडियम
Indiya	इंडिया
Indo	इंडो
Indonesia	इंडोनेशिया
Indra	इंद्र
Indradutt	इंद्रदत्त
Indrajit	इंद्रजीत
Indrani	इंद्राणी
Indraprastha	इंद्रप्रस्थ
Indrapriya	इंद्रप्रिया
Indravaraj	इंद्रवराज
Indrayani	इंद्रायणी
Indu	इन्दु
Indubhushan	इन्दुभूषण
Induja	इन्दुजा
Indukala	इन्दुकला
Indukanta	इन्दुकांता
Induma	इन्दुमा
Industrial	इंडस्ट्रियल
Industrial	इंडस्ट्रीयल
Industrie	इंडस्ट्री
Industries	इंडस्ट्रीज
Inesh	इनेश
Infotech	इंफोटेक
Ingalls	इंगल्स
Ingeborg	इंगबॉर्ग
Inigo	इनिगो
Injeeniyar	इंजीनियर
Inkulab	इंकलाब
Inline	इनलाइन
Innovations	इनोवेशन
Insaan	इंसान
Insan	इंसान
Insaniyat	इंसानियत
Instruments	इंस्ट्रुमेंट्स
Insurgente	इनसर्जंट
Inteqam	इंतिकाम
Inter	इंटर
Interactive	इंटरएक्टिव
Intesa	इंटेसा
Inti	इनटी
Intisar	इंतिसार
Intl	इंटल
Intrepid	इंट्रीपीड
Iodine	आयोडीन
Ipca	इप्का
Iphigenia	इफिगेनिआ
Ipsita	इप्सिता
Iqbal	इकबाल
Iraanaj	इरानज
Iran	ईरान
Iranian	ईरानियन
Iraq	इराक
Irfan	इरफान
Iria	इरिया
Irish	आयरिश
Iro	इरो
Iron	आइरन
Iron	आयरन
Irrigation	इरीगेशन
Irrisistible	इर्रेरिस्टेबल
Irvine	इरविन
Is	इज
Isabella	इसाबेला
Isabelle	इसाबेल
Isadora	इसाडोरा
Isanne	इसाने
Ishaq	इशाक
Ishara	इशारा
Ishika	ईशिका
Ishita	ईशिता
Ishq	इश्क
Ishwari	ईश्वरी
Islaam	इस्लाम
Isleen	इस्लीन
Isolde	आइसोल्ड
Ispat	इस्पात
Israel	इस्राइल
Ita	ईटा
Italia	इटालिया
Itihaas	इतिहास
Itimad	इतिमाद
Itni	इतनी
Ittefaq	इत्तिफाक
Ittefaq	इत्तेफाक
Ituran	इच्यूरन
Ivan	इवान
Ivi	इवि
Ivie	इवि
Ivo	इवो
Ivor	आइवर
Ivy	इवी
Iyailu	इयायलु
Izdihar	इज्दिहार
Izhaar	इजहार
Izzat	इज्जत
Ja	जा
Jaago	जागो
Jaamdar	जामदार
Jaandaar	जानदार
Jaanejaan	जानेजहा
Jaaneman	जानेमन
Jabalah	जबालेह
Jabbar	जब्बार
Jabeen	जबीन
Jabin	जबिन
Jabr	जब्र
Jacinto	जसिंटो
Jackie	जैकी
Jaclyn	जैकलिन
Jaclyn	जॉकलीन
Jacobs	जैकब्स
Jacobs	जैकॉब्स
Jacqui	जैकी
Jad	जद
Jadhav	जाधव
Jadugar	जादुगर
Jadugar	जादूगर
Jaegar	जैगर
Jafarwal	जफरवाल
Jaffar	जाफर
Jagadbandu	जगदबंधु
Jagadeep	जगदीप
Jagadeesh	जगदीश
Jagadip	जगदिप
Jagadish	जगदिश
Jaganmay	जगन्मय
Jagdamba	जगदंबा
Jagdeesh	जगदीश
Jagdish	जगदीश
Jagesh	जगेश
Jagger	जैगर
Jaggi	जग्गी
Jaggu	जग्गू
Jagir	जागीर
Jagran	जागरण
Jagriti	जागृति
Jagtap	जगताप
Jaguar	जैगुआर
Jahan	जहान
Jahankhela	जहाखेला
Jaheel	जहील
Jahm	जह्म
Jahres	जाहरेस
Jai	जय
Jaigarh	जयगड
Jaigopal	जयगोपाल
Jail	जेल
Jain	जैन
Jainarayan	जयनारायण
Jaipur	जयपुर
Jaisal	जैसल
Jaisalmer	जैसलमर
Jaishankar	जयशंकर
Jakhad	जाखड
Jal	जल
Jalaja	जलजा
Jalan	जलन
Jalandhri	जालंधरी
Jalangi	जलंगी
Jalaput	जालापुत
Jalaun	जालौन
Jale	जले
Jalendu	जलेंदु
Jalil	जलील
Jallad	जल्लाद
Jalsa	जलसा
Jalte	जलते
Jalwa	जलवा
Jam	जाम
Jamaica	जमैका
Jameson	जमेसन
Jamini	जामिनी
Jammu	जम्मू
Jamshed	जमशेद
Jan	जान
Janabai	जनाबाई
Janaki	जानकी
Janambhumi	जन्मभूमि
Janamejay	जनमेजय
Janardan	जनार्दन
Janasah	जनसह
Jane	जाने
Janet	जेनेट
Janette	जेनेट
Jangal	जंगल
Jangpuri	जंगपुरी
Jani	जानी
Janis	जेनिस
Janki	जानकी
Janm	जन्म
Janmabhoomi	जन्मभूमी
Jannah	जन्नाह
Janoo	जानू
January	जान्युअरी
Janwar	जानवर
Japendra	जपेंद्र
Japesh	जपेश
Japinder	जपिन्दर
Jaques	जैक्स
Jarabe	जराबे
Jarana	जराना
Jareer	जरीर
Jasapaal	जसपाल
Jase	जेस
Jashpur	जशपुर
Jasminder	जसमिंदर
Jasmund	जैसमंड
Jasodhara	जसोधरा
Jason	जेसन
Jason	जैसन
Jasoos	जासूस
Jasraj	जसराज
Jasvinder	जसविंदर
Jataa	जटा
Jaunie	जोयनी
Javed	जावेद
Jawab	जवाब
Jawahar	जवाहर
Jawaharke	जवहरके
Jawaharlal	जवाहरलाल
Jawani	जवानी
Jawhar	जवहार
Jaxon	जैक्सोन
Jaya	जया
Jayadeep	जयदीप
Jayalalita	जयललिता
Jayananda	जयनन्दा
Jayanti	जयंती
Jayasi	जायसी
Jayasinh	जयसिंह
Jayate	जयते
Jayawardene	जयवर्दने
Jayawardene	जयवर्धने
Jaydeep	जयदीप
Jaye	जाए
Jayegi	जाएगी
Jayshree	जयश्री
Jazbaat	जज्बात
Jeanette	जीनेट
Jeejaabaaee	जीजाबाई
Jeet	जीत
Jeeva	जीवा
Jeevan	जीवन
Jeevana	जीवना
Jeffrey	जैफरी
Jeganathan	जगनाथन
Jehan	जेहन
Jemma	जेमा
Jeneil	जेनील
Jenibelle	जेनिबेल
Jenifer	जेनिफर
Jenkins	जेनकिन्स
Jenna	जेना
Jennifer	जेनिफर
Jenny	जेनी
Jenolen	जेनोलेन
Jensen	जेनसन
Jera	जेरा
Jerauld	जेरोल्ड
Jeri	जेरी
Jerica	जेरिका
Jermaine	जरमायने
Jerom	जेरोम
Jerome	जेरोम
Jerry	जेरी
Jerry	जैरी
Jersey	जर्सी
Jeslyn	जेसलिन
Jessamine	जेसमिन
Jessica	जेसिका
Jessup	जेसप
Jett	जेट
Jewett	जेवेट
Jhabal	झबाल
Jhabbar	झब्बर
Jhajjar	झज्जर
Jhalak	झलक
Jhamela	झमेला
Jhanjhar	झांझर
Jharkhand	झारखंड
Jharna	झरना
Jharokhon	झरोखो
Jhelum	झेलम
Jhikka	झिक्का
Jhim	झिम
Jhoola	झूला
Jhoom	झूम
Jhoomer	झूमेर
Jhooth	झूठ
Jhootha	झूठा
Jhor	झोर
Jhutha	झूठा
Jiali	जिआली
Jibran	जिब्रान
Jigar	जिगर
Jigri	जिगरी
Jigya	जिज्ञा
Jigyasa	जिज्ञासा
Jihad	जिहाद
Jillian	जिलियन
Jimbo	जिम्बो
Jindal	जिंदाल
Jinelle	जिनेल
Jinendra	जिनेंद्र
Jiniteshnar	जिनितेष्णार
Jirair	जिरैर
Jiranimo	जिरानिमो
Jiroft	जिरोफ्ट
Jis	जिस
Jism	जिस्म
Jivana	जीवना
Jive	जीव
Jivin	जिविन
Jiyo	जियो
Jnanpith	ज्ञानपीठ
Jnyandeep	ज्ञानदीप
Jnyaneshwar	ज्ञानेश्वर
Joan	जोएन
Jocelyn	जोसेलिन
Joda	जोडा
Jodi	जोडी
Jodidar	जोडीदार
Joelle	जोएल्ल
Jog	जोग
Jogeendr	जोगींद्र
Jogi	जोगी
Jogindra	जोगींद्र
Johal	जोहल
Johanna	जोहन्ना
Johnavon	जॉनएवन
Johnson	जॉनसन
Johny	जॉनी
Jonathan	जॉनाथन
Jonathan	जोनाथन
Jonathan	जोनॅथन
Jonty	जोंटी
Jor	जोर
Jorge	जॉर्ज
Joroster	जोरोस्टर
Joseph	जॉसफ
Joseph	जोसफ
Josephat	जोस्फेट
Josephine	जोसफिन
Joshi	जोशी
Joshilay	जोशीले
Josie	जोसि
Joti	जोती
Journal	जर्नल
Journey	जर्नी
Jovanna	जोवन्ना
Jovianne	जोविएन
Jovita	जोविता
Jowai	जोवई
Joyce	जॉएस
Joyce	जॉयसी
Juan	जुआन
Juan	जुऑन
Judamnah	जुदम्नाह
Judd	जड्ड
Judo	जुडो
Judy	जुडी
Jugal	जुगल
Jugasankha	जुगसंखा
Jugnu	जुगनू
Juhaym	जुहायम
Juhi	जुही
Jui	जुई
Juily	जूली
Julakka	जुलक्का
Julian	जूलियन
Julien	जूलियन
Juma	जुमा
Jumanah	जुमनाह
Jumaymah	जुमयमाह
Jumaynah	जुमयनाह
Jumbish	जुम्बिश
Junaid	जुनैद
Jundub	जुन्दुब
Juneja	जुनेजा
Jungbaaz	जंगबाज
Jungle	जंगल
Junglee	जंगली
Junior	जुनियर
Junior	जूनियर
Junior	ज्युनियर
Junius	जूनियस
Juno	जुनो
Junoon	जुनून
Jura	जुरा
Jurangpathy	जुरंगपथी
Jurmana	जुर्माना
Jurrat	जुर्रत
Justice	जस्टिस
Justin	जस्टिन
Justise	जस्टिस
Juwariyah	जुवारियाह
Jwaharlal	जवाहरलाल
Jyot	ज्योत
Jyoti	ज्योति
Jyotsanaa	ज्योत्सना
Ka	का
Ka	के
Kaal	काल
Kaalahar	कालाहर
Kaalanjay	कालंजय
Kaalaraatri	कालरात्रि
Kaamagni	कामाग्नि
Kaamalwala	कामलवाला
Kaamanaa	कामना
Kaamchor	कामचोर
Kaanade	कानडे
Kaanch	काच
Kaanchanee	कांचनी
Kabbani	कब्बानी
Kabil	काबिल
Kabirah	कबीराह
Kabootar	कबूतर
Kabrastan	कब्रिस्तान
Kachcha	कच्चा
Kachche	कच्चे
Kachchi	कच्ची
Kacheri	कचेरी
Kacia	केसिया
Kadambari	कादम्बरी
Kaden	कादेन
Kadshah	कदशाह
Kafan	कफन
Kahaaboman	कहाबोमन
Kahan	कहां
Kahe	कहे
Kaheesha	कहीशा
Kahin	कही
Kaho	कहो
Kahoon	कहू
Kaif	कैफ
Kaila	कैला
Kailaash	कैलाश
Kailas	कैलास
Kailash	कैलाश
Kailashpati	कैलाशपति
Kaisa	कैसा
Kaise	कैसे
Kaiser	कैसर
Kaitabhajit	कैटभजित
Kaithal	कैथल
Kaitlyn	कैटलिन
Kajima	कजीमा
Kakadu	काकाडू
Kakrala	ककराला
Kalaa	कला
Kalabaaz	कलाबाज
Kalanidhi	कलानिधि
Kalea	कैलिया
Kalhan	कल्हन
Kali	कली
Kali	काली
Kalimantan	कलीमथंन
Kalimohan	कालिमोहन
Kalindi	कालिन्दी
Kalinjar	कलिंजर
Kalista	कलिस्टा
Kalkin	कल्किन
Kallicharran	कालीचरन
Kallima	कैलिमा
Kallis	कैलिस
Kallol	कल्लोल
Kaluwitharana	कालुविथराणा
Kalyug	कलयुग
Kam	कम
Kamadev	कामदेव
Kamai	कमाई
Kamalabhaanasinh	कमलभानसिंह
Kamalaj	कमलज
Kamalakshi	कमलाक्षी
Kamalini	कमलिनी
Kamalkali	कमलकली
Kamana	कामना
Kamande	कमांडे
Kambas	कैम्बास
Kamboj	कंबोज
Kamera	कामेरा
Kamesh	कामेश
Kamilah	कमिलाह
Kamna	कामना
Kamraj	कामराज
Kamran	कामरान
Kan	कण
Kanadi	कानडी
Kanak	कनक
Kanakpriya	कनकप्रिया
Kananbala	काननबाला
Kanchana	कंचना
Kanchanaa	कंचना
Kandarpa	कन्दर्प
Kane	कैनी
Kanetkar	कानेटकर
Kang	कंग
Kanhai	कन्हाई
Kanika	कनिका
Kanishka	कनिष्का
Kanitkar	कानिटकर
Kanjan	कंजन
Kankana	कंकणा
Kanker	कांकेर
Kannanur	कन्नानूर
Kannapuram	कन्नापुरम
Kanoun	कैनाउन
Kanpuri	कानपुरी
Kansas	कंसास
Kanta	कान्ता
Kanta	कांता
Kanti	कांति
Kanvalajeetasinh	कंवलजीतसिंह
Kanvalasinh	कंवलसिंह
Kanvar	कंवर
Kanwal	कंवल
Kanwaljeet	कंवलजीत
Kanwalkishore	कंवलकिशोर
Kanwarlal	कंवरलाल
Kanzah	कंजाह
Kapaleeshwara	कपालेश्वर
Kapde	कापडे
Kapoor	कपूर
Kapshe	कापशे
Kara	कारा
Karam	करम
Karambelkar	करंबेलकर
Karamdata	करमदाता
Karanasinh	करणसिंह
Karanasinh	करनसिंह
Karandikar	करंदीकर
Karee	करि
Kareem	करीम
Karen	करेन
Karenge	करेंगे
Kargil	कारगील
Karim	करीम
Karimnagar	करीमनगर
Karishma	करीश्मा
Karla	कार्ला
Karli	कर्ली
Karlsborg	कार्ल्सबोर्ग
Karm	कर्म
Karmalkar	करमलकर
Karna	कर्ण
Karnik	कार्णिक
Karorepati	करोड़पति
Karston	कार्स्टन
Kartar	कर्तार
Karthik	कार्तिक
Karunamay	करुणामय
Karunashankar	करुणाशंकर
Karvi	कार्वी
Kasal	कासल
Kasam	कसम
Kashef	कशेफ
Kashelikar	कशेलीकर
Kashif	काशिफ
Kashikar	काशीकर
Kashima	काशिमा
Kashiprasad	काशीप्रसाद
Kashmakash	कश्मकश
Kashmira	कश्मीरा
Kashyap	कश्यप
Kass	कैस
Kasungu	कासुंग्यु
Katak	कटक
Kate	काटे
Kateb	कातेब
Katelin	कैटलिन
Kathajuri	काठजुरी
Kathleen	कैथलीन
Kathmandu	काठमांडू
Kathpal	कठपाल
Kathputli	कठपुतली
Kathy	कैथी
Katie	कैटी
Katima	कैटीमा
Katni	कटनी
Kato	कटो
Kato	केटो
Katong	कैटॉन्ग
Katsuragi	कत्सूरागी
Kattora	कत्तौरा
Katy	कैटी
Kaua	कायुआ
Kaumudi	कौमुदी
Kaun	कौन
Kaushalya	कौशल्या
Kavignar	कविग्नर
Kaviraj	कविराज
Kavita	कविता
Kavli	कावली
Kawabata	कावाबाटा
Kawardha	कवर्धा
Kawkab	कवकाब
Kay	के
Kaya	काया
Kaydence	केडेंस
Kaylee	केली
Kayo	कायो
Kaysah	कैसाह
Kaz	काज
Kazmaier	कज्मायर
Keagan	कीगन
Kedarnath	केदारनाथ
Keefer	कीफर
Keele	कीले
Keelia	कीलिया
Keelty	कील्टी
Keely	कीली
Keemat	कीमत
Keep	कीप
Kehkashan	कहकशा
Kehte	कहते
Keitha	कैथा
Kelavarapalli	केलावरापल्ली
Kelimutu	केलीमुटु
Kelley	कैली
Kelli	केली
Kelton	केल्टन
Kemp	केंप
Kemp	केम्प
Kena	केना
Kenadia	केनेडिया
Kenamu	केनामू
Kendra	केंड्रा
Kenilworth	केनिलवर्थ
Kenisha	केनिशा
Kennan	केन्नन
Kenneth	कीनॅथ
Kenneth	कैनॅथ
Kennice	केनीस
Kennings	केनिंग्स
Kenton	केंटन
Kenyir	केनईर
Keoladeo	केवलादेव
Kermit	केर्मिट
Kerryn	केरीन
Kershaw	कर्शो
Kesaree	केसरी
Kesari	केसरी
Kesgarh	केसगढ
Keshavdas	केशवदास
Keshi	केशि
Kesoram	केसोरम
Ketaki	केतकी
Ketan	केतन
Kevin	केविन
Kevina	केविना
Kevorkian	केवोर्कियन
Khadatkar	खडतकर
Khadijah	खदिजाह
Khadikar	खडीकर
Khadim	खादिम
Khafid	खाफिद
Khag	खग
Khahira	खहिरा
Khaiyyam	खैय्यम
Khajit	खजित
Khalaf	खलाफ
Khalidah	खलिदाह
Khalifa	खलीफा
Khalil	खलिल
Khalil	खलील
Khaliq	खलीक
Khalis	खलीस
Khalisah	खलिसाह
Khalsa	खालसा
Khambete	खांबेटे
Khammam	खम्माम
Khamosh	खामोश
Khan	खान
Khandaan	खानदान
Khandekar	खांडेकर
Khandesh	खानदेश
Khandeshi	खानदेशी
Khandur	खंडूर
Khanjar	खंजर
Khansa	खानसा
Khanwalkar	खानवलकर
Khara	खरा
Khare	खरे
Khartoum	खारटूम
Khasgiwale	खासगीवाले
Khateeb	खातीब
Khatkadkala	खटकडकाला
Khatre	खतरे
Khatri	खत्री
Khatron	खतरो
Khatta	खट्टा
Khattar	खट्टर
Khatu	खाटु
Khaufnak	खौफनाक
Khayar	खयार
Khayyat	खय्यात
Khelne	खेलने
Khelo	खेलो
Khemprakash	खेमप्रकाश
Kher	खेर
Khera	खेरा
Khidmatgar	खिदमतगार
Khidr	खिद्र
Khidrah	खिदराह
Khiladi	खिलाडी
Khile	खिले
Khilona	खिलौना
Khilone	खिलोने
Khingan	खिंगन
Khirash	खिराश
Khota	खोटा
Khrushchev	ख्रुश्चेव
Khubsurat	खूबसूरत
Khudai	खुदाई
Khukhren	खुखरेन
Khul	खुल
Khulayd	खुलायद
Khulud	खुलुद
Khumaanasinh	खुमानसिंह
Khungra	खुंगरा
Khurd	खुर्द
Khurn	खुर्न
Khursheed	खुर्शीद
Khush	खुश
Khushaboo	खुशबू
Khushal	खुशाल
Khushee	खुशी
Khusro	खुसरो
Khwab	ख्वाब
Ki	की
Kibey	किबे
Kiev	कीव
Kigali	किगाली
Kila	किला
Kilauea	किलाउई
Kim	किम
Kimberly	किंबर्लि
King	किंग
Kingfisher	किंगफिशर
Kingston	किंगस्टन
Kingston	किंग्स्टन
Kintan	किंतन
Kira	किरा
Kiranmala	किरणमाला
Kiraye	किराए
Kiril	किरील
Kirtana	कीर्तना
Kirti	किर्ति
Kirti	कीर्ति
Kirtikumar	कीर्तिकुमार
Kirtinasha	कीर्तिनाशा
Kirtley	कर्टले
Kishanganj	किशनगंज
Kishor	किशोर
Kishori	किशोरी
Kisite	किसाइट
Kiski	किसकी
Kismat	किस्मत
Kismatwali	किस्मतवाली
Kitna	कितना
Kitty	किटी
Kiya	किया
Klamath	क्लामथ
Klang	क्लैंग
Klarika	क्लारिका
Klyuchevskaya	क्लुचेबस्क्या
Knott	नॉट
Knox	नॉक्स
Knox	नोक्स
Knud	कनुद
Knut	नट
Knuth	नुथ
Ko	को
Kobe	कोब
Kobsa	कोब्सा
Koc	कॉक
Koch	कोच
Kodaganar	कोडागनर
Kodak	कॉडैक
Kodak	कोडेक
Kodgu	कोडगू
Koen	कोएन
Kohima	कोहीमा
Kohn	कोहन
Kolbe	कोल्बे
Kolina	कोलिना
Kolkata	कोलकाता
Kolvada	कोल्वाडा
Komatsu	कोमात्सु
Kong	कोंग
Koningshooykt	कॉनिंगशूयक्ट
Kooner	कूनेर
Korba	कोरबा
Korbin	कोर्बिन
Korde	कोरडे
Koren	कोरेन
Kortenaer	कॉर्टेनेर
Kosi	कोसी
Kossuth	कोसुथ
Kotak	कोटक
Kotnis	कोटनीस
Kottayam	कोट्टायम
Kowloon	कोवलून
Koyna	कोयना
Kozhikode	कोझिकोड
Kranti	क्रांती
Krashnaa	कृष्णा
Krataaraam	कृताराम
Kratz	क्रेट्ज
Kreeli	क्रीली
Krishna	कृष्णा
Krishnachandra	कृष्णचंद्र
Krishnagiri	कृष्णागिरी
Krishnakanta	कृष्णकांत
Krishnakumar	कृष्णकुमार
Krishnamurari	कृष्णमुरारी
Krishnavatar	कृष्णावतार
Krodh	क्रोध
Kronprinz	क्रॉन्प्रिंज
Krupka	कृपका
Krystal	क्रिस्टल
Ksena	क्सेना
Kshirsagar	क्षीरसागर
Kshitij	क्षितिज
Kuaybah	कुयबाह
Kubra	कुबरा
Kuch	कुछ
Kuchh	कुछ
Kucinich	कुचिनिक
Kudrat	कुदरत
Kudremukh	कुदरेमुख
Kuggeleijn	कगलेजिन
Kuhad	कुहड
Kuhada	कुहाडा
Kukreja	कुकरेजा
Kulachi	कुलाची
Kularanjan	कुलरंजन
Kulbhushan	कुलभूषण
Kuldeep	कुलदीप
Kuldeepak	कुलदीपक
Kullursandai	कुल्लुरसन्दई
Kumaran	कुमारन
Kumari	कुमारी
Kumble	कुंबले
Kumud	कुमुद
Kund	कुन्द
Kundan	कुंदन
Kundan	कुन्दन
Kuntaa	कुंता
Kunwara	कुंवारा
Kup	कप
Kurayb	कुरायब
Kurfurst	कर्फस्ट
Kursi	कुर्सी
Kurt	कर्ट
Kurt	कुर्त
Kurukshetra	कुरुक्षेत्र
Kuruppu	कुरुप्पु
Kusagra	कुसाग्र
Kush	कुश
Kushinagar	कुशीनगर
Kusumlata	कुसुमलता
Kutai	कुताई
Kutch	कच्छ
Kutharaiyar	कुथारइयर
Kutumbale	कुटुंबले
Kutumbe	कुटुंबे
Kville	क्वीले
Kya	क्या
Kyle	काइल
Kylee	कायली
Kyleigh	कायली
Kylene	कायलीन
Kyna	कायना
Kynthia	कायंथिया
Kyoto	क्योटो
Kyria	कायरिया
Kyushu	क्यूशू
Laabhante	लाभांते
Laadla	लाडला
Laaj	लाज
Laakhan	लाखन
Laakshaa	लाक्षा
Laalachand	लालचंद
Laalamani	लालमणि
Laalasaa	लालसा
Laalee	लाली
Laari	लारी
Laash	लाश
Laat	लाट
Lab	लैब
Labangalata	लबंगलता
Labeeb	लबीब
Labibah	लबीबाह
Labopharm	लैबोफार्म
Labour	लेबर
Labrooy	लेबरूय
Labrooy	लैब्रूय
Lachak	लचक
Lacrosse	लैक्रोस
Lacy	लेसी
Lada	लडा
Ladaaku	लडाकू
Laddie	लेडी
Laden	लादेन
Ladka	लडका
Ladkiyan	लडकिया
Lady	लेडी
Laeeq	लईक
Lafarge	लैफर्ज
Lafayette	लैफायेट्ट
Lag	लग
Laga	लगा
Lagan	लगन
Lagan	लगान
Lagna	लग्न
Lagoon	लगून
Lagunas	लागुआन्स
Lagunas	लॅगुनास
Laheri	लहरी
Lahore	लाहोर
Lahore	लाहौर
Lainey	लैनी
Laith	लाइथ
Lajwanti	लाजवंती
Lake	लेक
Lakeeren	लकीरे
Lakhan	लखन
Lakhanpal	लखनपाल
Lakhimpur	लखीमपुर
Lakhpati	लखपति
Lakshadweep	लक्षद्वीप
Lakshana	लक्षणा
Lakshmee	लक्ष्मी
Lakshya	लक्ष्य
Laladu	लालदू
Lalan	ललन
Lali	लाली
Lalima	लालिमा
Lalit	ललित
Lalitaa	ललिता
Lalitchandra	ललितचंद्र
Lalith	ललिथ
Lalitkumar	ललितकुमार
Lalitmohan	ललितमोहन
Lalitpur	ललितपुर
Lalkaar	ललकार
Lama	लामा
Lamar	लैमर
Lamba	लांबा
Lambda	लांबडा
Lambe	लंबे
Lambeth	लैंबेथ
Lameck	लैमेक
Lamisah	लेमिसाह
Lana	लाना
Lancaster	लैंकेस्टर
Lancaster	लैनकेस्टर
Lance	लांस
Lance	लैन्स
Lancelot	लांसलोट
Landers	लेन्डर्स
Landers	लैंडर्स
Landguard	लैंडगार्ड
Landis	लेन्डिस
Landler	लैंडलर
Landmark	लैंडमार्क
Landon	लंदन
Lane	लेन
Langde	लंगडे
Langstone	लैंगस्टोन
Lanier	लानीयर
Lanka	लंका
Lanoptics	लेनऑप्टिक्स
Lansbury	लॅन्सबरी
Lanza	लैंजा
Lao	लाओ
Laparwah	लापरवाह
Laraine	लारेन
Larchmont	लार्चमॉन्ट
Lark	लार्क
Larkins	लार्किंस
Larry	लेरी
Lashkaree	लश्करी
Lasith	लसिथ
Lassie	लैसी
Laszlo	लास्ज्लो
Lateef	लतीफ
Latham	लैथम
Lathrop	लैथ्रोप
Latifah	लतीफाह
Latona	लैटोना
Laura	लॉरा
Laura	लौरा
Laurel	लॉरेल
Laurence	लॉरेंस
Laurens	लॉरेंस
Laureus	लॉरेस
Lauria	लॉरिया
Laut	लौट
Lavaa	लावा
Lavaca	लवैका
Lavada	लवेडा
Lavalee	लवली
Lavonn	लैवॉन
Lawaaris	लावारिस
Lawate	लवाटे
Lawrence	लॉरेन्स
Lawrencia	लॉरेंसिया
Lawry	लॉरी
Lawson	लॉसन
Laxmi	लक्ष्मी
Laxminarayan	लक्ष्मीनारायण
Layak	लायक
Laylo	लायलो
Layyah	लय्याह
Lazzaro	लैजारो
Leading	लीडिंग
Leane	लीन
Leanne	लीअनी
Leavitt	लेविट
Leda	लेडा
Ledell	लेडेल
Lee	ली
Leeds	लीड्स
Leedstown	लीड्सटाउन
Leelaaraam	लीलाराम
Leelavati	लीलावती
Legend	लेजेंड
Lehman	लेहमेन
Leiberty	लिबर्टी
Leicester	लीसेस्टर
Leighanna	लैघन्ना
Lein	लेन
Lekh	लेख
Lekha	लेखा
Lel	लेल
Lelia	लिलिया
Lempira	लेम्पिरा
Lenawee	लिनावी
Leno	लेनो
Lenore	लेनोर
Leola	लियोला
Leoma	लियोमा
Leone	लियॉन
Leonora	लियोनोरा
Leopard	लेपर्ड
Lerato	लेरेटो
Lesa	लेसा
Lester	लेस्टर
Letterman	लेटरमॅन
Lettre	लेटर
Leu	लेउ
Levana	लेवेना
Levar	लिवर
Lexi	लेक्सी
Lexine	लेक्सिन
Lexington	लेक्जिंगटन
Liaqat	लियाकत
Liberty	लिबर्टी
Liberty	लिर्बटी
Libong	लिंबॉग
Libra	लिब्रा
Lidia	लिडिया
Liechtenstein	लीकटेंस्टीन
Lierre	लिएरे
Liers	लियर्स
Liezele	लायजेल
Life	लाइफ
Life	लाईफ
Liggett	लिगेट
Lighthouse	लाइटहाउस
Lilli	लिली
Lilly	लिली
Lilongwe	लिलाँग्वे
Lily	लिली
Lima	लीमा
Limazah	लिमजाह
Lin	लिन
Linaeve	लिनाएव
Linate	लिनेट
Lincoln	लिंकोलन
Linda	लिंडा
Lindu	लिंदू
Line	लाइन
Lines	लाइन्स
Lipman	लिपमैन
Lira	लिरा
Lisbon	लिस्बन
Liscard	लिस्कार्ड
Lisette	लिसेट
Litan	लिटान
Literary	लिट्रेरी
Literature	लिट्रेचर
Littlehampton	लिटिलहैम्पटन
Liv	लिव
Liverpool	लिवरपूल
Livett	लिवेट
Livi	लिवी
Living	लिविंग
Livvy	लिवी
Liya	लिया
Liyaqat	लियाकत
Liye	लिए
Lloyd	लॉएड
Lloyd	लॉयड
Lloyds	लॉयड्स
Loafer	लोफर
Lock	लॉक
Log	लोग
Logan	लोगान
Logie	लॉगी
Logitech	लॉजीटेक
Lokaadhip	लोकाधिप
Lokesh	लोकेश
Lokmat	लोकमत
Loknath	लोकनाथ
Lokprakash	लोकप्रकाश
Loksatta	लोकसत्ता
Lokuhettige	लोकुहेटिज
Lole	लोले
Loman	लोमैन
Long	लॉन्ग
Longowal	लोंगोवाल
Lopa	लोपा
Lorelei	लोरेलेय
Lorence	लॉरेंस
Lorentz	लॉरेंत्ज
Loretta	लोरेट्टा
Lori	लोरी
Lorraine	लोरैन
Lotta	लोट्टा
Lotte	लोट्टी
Lottie	लोटी
Loughborough	लोघबॉरोघ
Louie	लुई
Louis	लुईस
Louis	लूइस
Louisbourg	लुइसबर्ग
Loveridge	लवरिज
Lovey	लोवी
Lovrijenac	लॉव्रीजेनैक
Lower	लोवर
Lowes	लॉव्ज
Lowndes	लॉनडेस
Lowri	लोरी
Lowther	लॉथर
Lu	लु
Luanda	लुआंडा
Lubabah	लुबबाह
Lucas	लुकास
Lucas	लूकास
Luciano	ल्युसिआनो
Lucil	ल्युसिल
Lucinda	ल्यूसिंडा
Lucio	ल्यूसिओ
Lucius	ल्यूसियस
Luckhurst	लकहर्स्ट
Lucknow	लखनौ
Lucrece	ल्यूक्रेस
Ludhiana	लुधियाना
Ludhianwi	लुधियानवी
Luharwali	लुहरवाली
Luigi	लुइगी
Luke	ल्यूक
Lulu	लुलु
Lumps	लम्प्स
Luqman	लुक्मान
Lute	ल्यूट
Lutetium	ल्यूटेशियम
Lutf	लुत्फ
Luthando	लुथेन्डो
Lutheran	लुथेरान
Luzon	लुजॉन
Lychnostatis	लिक्नोस्टेटिस
Lycoris	लाइकोरिस
Lynda	लिंडा
Lynelle	लाइनेल
Lynsey	लिनसे
M	एम
Ma	मा
Maad	माड
Maadhavee	माधवी
Maajha	माझा
Maajid	माजिद
Maal	माल
Maan	मान
Maanakalaal	माणकलाल
Maang	माँग
Maaruti	मारुति
Maarzi	मर्जी
Maasoom	मासूम
Maatrakaa	मातृका
Maayaa	माया
Maayaaraam	मायाराम
Mabel	मबेल
Mabli	मब्लि
Macalpine	मैकएल्पिन
Machhal	मछल
Machine	मशीन
Mackreth	मॅकक्रेथ
Maclean	मैक्लीन
Maclear	मैकलियर
Macleod	मैकलेओड
Macleod	मैकलेयोड
Macon	मेकॉन
Macquarie	मैकक्वेरी
Macronix	मैक्रॉनिक्स
Madalasa	मदलसा
Madam	मैडम
Madanamohan	मदनमोहन
Madaniyah	मदनियाह
Maddy	मैडी
Madhavdas	माधवदास
Madhavi	माधवी
Madhepura	मधेपुरा
Madhpura	मधपुरा
Madhsudan	मधुसूदन
Madhu	मधु
Madhubani	मधुबनी
Madhuksara	मधुक्षरा
Madhulata	मधुलता
Madhulika	मधुलिका
Madhumay	मधुमय
Madhuri	माधुरी
Madhusudan	मधुसूदन
Madirakshi	मदिराक्षी
Madivan	मादिवन
Madmust	मदमस्त
Madonna	मेडोना
Madonna	मैडोना
Madpuri	मदपुरी
Madugalle	मदुगल्ले
Madurai	मदुरै
Madurasinghe	मदुरासिंघे
Mae	मइ
Mafizur	मफिजुर
Magan	मगन
Magana	मगना
Maganalaal	मगनलाल
Magar	मगर
Magdala	मग्दला
Magellan	मेगॅलन
Magellan	मैगलन
Magenta	मैजंटा
Magnificent	मैग्नीफिकेंट
Magoffin	मैगोफिन
Magroor	मगरूर
Magsaysay	मेगसेसे
Maguire	मेग्यूर
Mahaa	महा
Mahaabal	महाबल
Mahaamanaa	महामना
Mahaamantree	महामंत्री
Mahaan	महान
Mahaaraaj	महाराज
Mahaaraajasinh	महाराजसिंह
Mahaatikt	महातिक्त
Mahaavat	महावत
Mahaaveer	महावीर
Mahaayogee	महायोगी
Mahabali	महाबली
Mahabalipuram	महाबलीपुरम
Mahad	महाड
Mahadane	महादाणे
Mahadev	महादेवी
Mahageet	महागीत
Mahajan	महाजन
Mahajana	महाजन
Mahakaleshwar	महाकालेश्वर
Mahakali	महाकाली
Mahakutta	महाकुट्ट
Mahal	महल
Mahalakshmi	महालक्ष्मी
Mahalia	महालीया
Mahanadi	महानदी
Mahanagar	महानगर
Mahanama	महानामा
Mahananda	महानंदा
Maharaja	महाराजा
Maharnav	महार्नव
Mahasamund	महासमुंद
Mahati	महती
Mahatma	महात्मा
Mahavat	महावत
Mahavira	महावीर
Mahbub	महबूब
Mahbubah	महबूबा
Maheena	महीना
Maheepati	महीपती
Maher	माहेर
Mahes	महेस
Maheshwar	महेश्वर
Mahfuz	महफूज
Mahika	महिका
Mahil	माहिल
Mahindra	महिंद्र
Mahindra	महिंद्रा
Mahiwal	महिवाल
Mahla	माहला
Mahmi	माहमी
Mahmood	महमूद
Mahmood	मेहमूद
Mahmudah	महमूद
Mahoba	महोबा
Mahogany	महोगनी
Mahua	महुआ
Maid	मेड
Maida	मैदा
Mailer	मेलर
Maili	मैली
Main	में
Main	मै
Maine	मैंने
Maire	मैरे
Mairead	मैरिअड
Mairi	मैरी
Maisie	मैसी
Maitraavaruni	मैत्रावरुणि
Maitree	मैत्री
Maitreyi	मैत्रेयी
Maitri	मैत्री
Majarooh	मजरूह
Majboori	मजबूरी
Majdi	मज्दी
Majedaar	मजेदार
Majitha	मजीठा
Major	मेजर
Makasood	मकसूद
Makhani	मखानी
Makhowal	माखोवाल
Makhtoonah	मख्तूनह
Makia	मल्लिका
Makita	माकिटा
Makkad	मक्कड
Makowal	माकोवाल
Makpo	मैक्पो
Malacca	मलाक्का
Malati	मालती
Malaya	मलया
Malayala	मालायला
Malborough	मैलबोरॉ
Malcolm	माल्कोल्म
Malcolm	मैल्कोम
Malda	मालदा
Male	मेल
Maleehah	मलीहाह
Malhan	मल्हान
Malhar	मल्हार
Mali	माली
Malik	मलिक
Malikaa	मलिका
Malikah	मलिकाह
Malissa	मैलिसा
Malkin	मालकिन
Mallah	मल्लाह
Mallesh	मल्लेश
Mallett	मैलेट
Malli	मल्ली
Mallorca	मल्लोर्का
Mallorie	मैलोरी
Malpensa	मालपेन्सा
Maltese	मैटलीज
Maluka	मलूका
Malvina	माल्विना
Mama	मामा
Mamata	ममता
Mamduh	मम्दूह
Mamla	मामला
Mamo	मामो
Mamun	मैमून
Man	मेन
Man	मैन
Mana	माना
Manaakshu	मनाक्क्षु
Manal	मनल
Manar	मनर
Manar	मनार
Manasaa	मनसा
Manasijaa	मनसिजा
Manasvee	मनस्वी
Manchali	मनचली
Mandaa	मंदा
Mandahaas	मंदहास
Mandakranta	मन्दक्रांता
Mandal	मंडल
Mandan	मंडन
Mandan	मैंडन
Mandar	मन्दर
Mandara	मन्दरा
Mandarmalika	मन्दारमलिका
Mandela	मंडेला
Mandira	मन्दिरा
Mandu	मांडू
Mandya	मण्डया
Manfoosah	मनफूसाह
Mang	मांग
Mangal	मंगल
Mangalaa	मंगला
Mangalam	मंगलम
Mangalore	मैंगलोर
Mangesh	मंगेश
Mangetar	मंगेतर
Mangu	मंगु
Manhattan	मॅनहॅटन
Manhattan	मैनहटन
Mani	मणि
Mani	मणी
Mani	मनी
Manibandh	मणिबंध
Manimala	मणिमाला
Manimuthar	मणिमुथर
Manindra	मणिंद्र
Maniram	मणिराम
Manish	मनीष
Manisha	मनीषा
Manishankar	मणिशंकर
Manjalar	मंजलर
Manjaree	मंजरी
Manjareek	मंजरीक
Manjeer	मंजीर
Manjira	मंजिरा
Manjooshaa	मंजूषा
Manjrekar	मांजरेकर
Manju	मंजु
Manjubala	मंजुबाला
Manjula	मंजुला
Manjusha	मंजूषा
Mankad	मांकड
Manmukhani	मनमुखानी
Mannaan	मन्नान
Mannan	मन्नान
Mannava	मनवा
Manners	मेनर्स
Manobhu	मनोभु
Manoel	मैनोएल
Manohar	मनोहर
Manoj	मनोज
Manojavaa	मनोजवा
Manoram	मनोरम
Manorama	मनोरमा
Manoranjan	मनोरंजन
Manoranjana	मनोरंजना
Manprasad	मनप्रसाद
Mansite	मैनसाइट
Manson	मेन्सन
Mansukh	मनसुख
Mansur	मंसूर
Mantar	मंतर
Mantrarshi	मंत्रर्षि
Manu	मनु
Manulife	मैन्युलाइफ़
Manurkar	मानुरकर
Manyara	मन्यारा
Manzana	मंजाना
Manzilen	मंजिले
Mao	माओ
Maputo	मेपटो
Maqbul	मकबूल
Maqsad	मकसद
Maqsood	मकसूद
Maqsud	मकसूद
Maradh	मराध
Marakele	माराकेले
Marathwada	मराठवाडा
Marcel	मार्सेल
March	मार्च
Marconi	मारकोनी
Marcus	मार्कस
Mardav	मार्दव
Mareechi	मारीची
Marengo	मैरेंगो
Margherita	मार्गरीटा
Margo	मार्गो
Margot	मार्गोट
Mari	मारी
Marian	मारिआन
Marian	मैरियन
Marianne	मॅरिन
Maribeth	मरिबेथ
Marichi	मरिची
Marico	मैरिको
Maricopa	मेरीकोपा
Marillier	मैरीलियर
Marilu	मेरिलु
Marimbas	मैरिमबास
Marine	मरीन
Marine	मैरीन
Marion	मॅरिअन
Marion	मैरियन
Marisa	मैरिसा
Mariska	मैरिस्का
Maritime	मैरिटाइम
Maritime	मैरीटाइम
Marjanah	मर्जनाह
Markets	मार्केट्स
Markgraf	मार्कग्रेफ
Marlee	मार्ली
Marlon	मर्लोन
Marlon	मार्लोन
Marmit	मर्मित
Marriage	मैरेज
Marseille	मार्सेइले
Marsh	मार्श
Marsha	मर्शा
Mart	मार्ट
Marte	मरते
Martin	मॉर्टन
Martini	मार्टिनी
Martir	मार्टिर
Maruf	मारूफ
Marukar	मरुकर
Marutvan	मारुतवन
Marvela	मार्वेला
Marvell	मार्वल
Marwah	मरवाह
Marwan	मरवन
Mary	मेरी
Maryland	मेरीलैंड
Masabeeh	मसबीह
Masada	मसादा
Mashaal	मशाल
Mashakoor	मशकूर
Mashal	मशाल
Mashkur	मश्कूर
Mashoodah	मशूदाह
Mashooq	माशूक
Masood	मसूद
Massachusetts	मैसाच्युसेट्स
Massie	मैस्सी
Massimo	मस्सिमो
Mastana	मस्ताना
Master	मास्टर
Masters	मास्टर्स
Masumah	मासूमा
Matanga	मातंग
Matange	मटंगे
Matawle	मतवले
Mateo	मटेओ
Mathrubhumi	मातृभूमि
Mathura	मथुरा
Matilda	मटिल्डा
Matkari	मतकरी
Matlabi	मतलबी
Matogrossense	मॅटोग्रोसेंस
Matra	मात्र
Matrix	मैट्रिक्स
Matthew	मेथ्यू
Matthew	मैथ्यू
Matthews	मैथ्यूज
Matthews	मैथ्यूस
Matthias	मत्थिअस
Matus	मेट्यूस
Matwali	मतवाली
Maude	मौडे
Maugham	मॉघम
Maunath	मऊनाथ
Maura	मौरा
Maurice	मॉरिस
Maurice	मौरिस
Mauricie	मॉरिशी
Maurilio	मौरिलिओ
Mauritius	मॉरीशस
Mausi	मौसी
Mausmi	मौसमी
Mauve	मौवे
Mawaali	मवाली
Mawdud	मावदूद
Mawiyah	मवियाह
Max	मैक्स
Maxim	मैक्सिम
Maxima	मेक्सिमा
Maxwell	मैक्सवेल
May	मे
Maya	माया
Mayank	मयंक
Maylin	मायलिन
Maymun	मयमून
Mayo	मेयो
Mayon	मायोन
Maysarah	मय्यसरह
Mayura	मयूरा
Mayurakshi	मयूराक्षी
Mazda	मज्दा
Mazloom	मजलूम
Mburo	मबूरो
Mcallister	मैकऑलिस्टर
Mccarthy	मॅकॉर्थी
Mcculloch	मैककुलॉक
Mcdonalds	मैकडॉनल्ड्स
Mcdowell	मैकडॉवेल
Mcentire	मॅकएंटायर
Mcguire	मॅकगुयर
Mcintyre	मैकइंटायर
Mclennan	मैकलेनन
Mcmurray	मैकमुर्रे
Mcnab	मैकनैब
Medal	मेडल
Medalists	मेडलिस्ट
Medera	मेडेरा
Medhaa	मेधा
Medhaavinee	मेधाविनी
Medhekar	मेढेकर
Medi	मेडी
Medical	मेडिकल
Mediceo	मेडीसीओ
Medini	मेदिनी
Medium	मीडियम
Meenakshi	मीनाक्षी
Meenar	मीनार
Meet	मीत
Megha	मेघा
Meghan	मेघन
Meghdutt	मेघदत्त
Meghna	मेघना
Meghraj	मेघराज
Mehak	महक
Mehandi	मेहंदी
Mehanga	महंगा
Meharbaan	मेहरबान
Meharbani	मेहरबानी
Meharbaniyan	मेहरबानिया
Mehboobnagar	महबूबनगर
Mehdi	मेहदी
Mehman	मेहमान
Mehmood	महमूद
Mehtab	मेहताब
Meigs	मेग्स
Meiji	मैजी
Mein	मे
Mein	मै
Meitnerium	मिटनेरियम
Mekhala	मेखला
Mekong	मेकोंग
Melanie	मेलाने
Melbourne	मेलबॉर्न
Melbourne	मेलबोर्न
Melchior	मेल्चिओर
Melita	मेलिटा
Mellette	मेलेट
Melodeon	मैलोडियन
Mem	मेम
Memsaab	मेमसाब
Menaka	मेनका
Menard	मेनार्ड
Mendhe	मेंढे
Menifee	मेनिफी
Mento	मैंटो
Mercantile	मर्केंटाइल
Merchants	मर्चंट्स
Meredith	मेरेडिथ
Meree	मेरी
Meri	मेरा
Meri	मेरी
Merite	मेरिट
Meriwether	मेरिवेदर
Merlin	मर्लिन
Merlin	मेर्लिन
Mervin	मेर्विन
Mervyn	मर्विन
Metallophone	मेटैलोफोन
Methodist	मेथोडिस्ट
Metripolitan	मेट्रोपॉलिटन
Metro	मेट्रो
Metro	मैट्रो
Mgahinga	मगाहिंगा
Mhambrey	म्हांब्रे
Mhatre	म्हात्रे
Michael	माइकल
Michaela	मिशेला
Michelle	मिशेल
Michigan	मिशिगन
Michikamau	मिचिकमाउ
Michilimackinac	मिशीलिमेकीनैक
Mico	माइको
Micro	माइक्रो
Microsystems	माइक्रोसिस्टम
Midday	मिड्डे
Midhvaan	मिधवान
Midvale	मिडवेली
Midway	मिडवे
Miffin	मिफिन
Mignon	मिग्नोन
Migros	माइग्रोज
Miguel	माइगुएल
Mikaia	मिकैया
Mikumi	मिकुमी
Milam	मिलाम
Milan	मिलन
Milan	मिलान
Mile	मिले
Milek	मिलेक
Miles	माइल्स
Miley	मिले
Milford	मिल्फोर्ड
Militari	मिलिटैरी
Mill	मिल
Millennium	मिलेनियम
Miller	मिलर
Millie	मिली
Millimes	मिलीमेस
Millionaire	मिलिअनैर
Mills	मिल्स
Milo	मिलो
Milogi	मिलोगी
Milt	मिल्ट
Milton	मिल्टन
Milun	मिलन
Mimbi	मिंबी
Mimis	मिमिस
Minakshi	मीनाक्षी
Minar	मीनार
Mindo	मिंदो
Mindy	मिंडी
Mineral	मिनरल
Minerva	मिनर्वा
Mineshvar	मिनेश्वर
Mingan	मिंगॅन
Minhaj	मिन्हाज
Minhajul	मिन्हाजुल
Minhas	मिनहास
Miniature	मिनिएचर
Mining	माइनिंग
Minna	मिन्ना
Minuet	माइनुएट
Miraglia	मिराग्लिया
Mirc	मिर्क
Mirch	मिर्च
Mirchandani	मीरचंदानी
Mirra	मिरा
Mirza	मिर्जा
Misaal	मिसाल
Misal	मिसाल
Misar	मिसर
Mishra	मिश्र
Mishra	मिश्रा
Misri	मिसरी
Miss	मिस
Missionary	मिशनरी
Missoula	मिसौला
Missouri	मिसॉरी
Missouri	मिसोरी
Missouri	मिसौरी
Misty	मिस्टी
Mita	मीता
Mitch	मिच
Mithilesh	मिथिलेश
Mithra	मिथ्रा
Mitsui	मित्सुई
Mittal	मित्तल
Mitti	मिट्टी
Mitul	मितुल
Mitumba	मिटुंबा
Mizoram	मिजोरम
Mizuho	मिजुहो
Modern	मॉडर्न
Modesta	मोडेस्टा
Modesto	मोडेस्टो
Modesty	मोडेस्टी
Modh	मोड
Modinha	मोडिन्हा
Moga	मोगा
Mohadkar	मोहाडकर
Mohamad	मोहमद
Mohammad	मोहम्मद
Mohammed	मोहम्मद
Mohinder	मोहिंदर
Mohinee	मोहिनी
Mohiniatam	मोहिनीअटम
Mohita	मोहिता
Mohnish	मोहनीश
Mohre	मोहरे
Mohsin	मोहसिन
Moin	मोइन
Moira	मोइरा
Molucca	मोलुक्का
Monarch	मॉनार्क
Monash	मोनैश
Monckton	मॉन्कटन
Monde	मोंडे
Mongia	मोंगिया
Mongo	मोंगो
Monish	मोनिश
Monmouth	मॉनमाउथ
Monmouths	मॉन्माउथ्स
Monnet	मोनेट
Monrovia	मोनरोविया
Montague	मोंटागुए
Monte	मॉन्टे
Monte	मोंटे
Monterey	मॉन्टरी
Monterey	मोंटेरे
Montgomery	मोंटगोमेरी
Montour	मॉन्टर
Montrose	मोंट्रोस
Monty	मोंटी
Moody	मूडी
Mookambika	मूकांबिका
Moore	मूर
Moores	मूर्स
Moors	मूर्स
More	मोरे
Morepen	मोअरपेन
Morgana	मोर्गना
Morkel	मॉर्कल
Morna	मोर्ना
Morning	मॉर्निंग
Moroni	मोरोनी
Morphy	मॉर्फी
Morrie	मोरी
Morris	मोरिस
Morrisa	मोरिसा
Morshed	मोरशद
Mortaza	मोरताजा
Moschip	मॉस्चिप
Moscow	मॉस्को
Moseley	मोसेले
Moser	मोजेर
Moses	मोसेस
Mosquitos	मॉस्किटोज
Most	मोस्ट
Moterwali	मोटरवाली
Motherson	मदरसन
Moti	मोती
Motion	मोशन
Motiwale	मोतीवाले
Motor	मोटर
Motors	मोटर्स
Mott	मॉट
Mountains	माउंटन्स
Mountains	माउंटेन्स
Mountrail	माउंट्रेल
Moxon	मॉक्सोन
Moyers	मोयर्स
Mozambik	मोझाम्बिक
Mozambique	मोजाम्बिक
Mradaa	मृदा
Mradulataa	मृदुलता
Mraganayanaa	मृगनयना
Mragayaa	मृगया
Mragendr	मृगेंद्र
Mranaal	मृणाल
Mranaalinee	मृणालिनी
Mridula	मृदुला
Mrinal	मृणाल
Mrinmayi	मृण्मयी
Mrityu	मृत्यु
Mrunalini	मृणालिनी
Muaid	मुएद
Muawwiz	मुआव्विज
Muazzam	मुअज्जम
Mubashir	मुबाशिर
Mubashirah	मुबाशिराह
Mubdee	मुब्दी
Mubdi	मुब्दी
Mubeenah	मुबीनाह
Mubin	मुबीन
Muchchal	मुच्चल
Mud	मुड
Mudabbir	मुदब्बिर
Mudris	मुद्रिस
Mudrit	मुद्रित
Mueed	मुईद
Mueen	मुईन
Mufakkir	मुफक्किर
Mufallah	मुफल्लाह
Muflih	मुफ़्लीह
Mugdha	मुग्धा
Mughaanee	मुघानी
Muhaasin	मुहासिन
Muhaayameen	मुहायमीन
Muhaayee	मुहायी
Muhaaymin	मुहायमीन
Muhammad	मुहम्मद
Muhammadee	मुहम्मदी
Muhar	मुहार
Muhasin	मुहासिन
Muhayamin	मुहायमीन
Muhayee	मुहायी
Muheet	मुहीत
Muhsin	मुहसिन
Muir	म्यूर
Muiz	मुईज
Mujaddid	मुजद्दिद
Mujaffarpur	मुजफ्फरपुर
Mujahid	मुजाहिद
Mujazziz	मुजज्जिज
Mujib	मुजीब
Mujra	मुजरा
Mukand	मुकुंद
Mukeria	मुकेरिया
Mukesh	मुकेश
Mukhda	मुखडा
Mukhtar	मुख्तार
Mukka	मुक्का
Mukta	मुक्ता
Muktaanbar	मुक्तांबर
Mukti	मुक्ति
Mukul	मुकुल
Mukulit	मुकुलित
Mukulita	मुकुलिता
Mukunda	मुकुन्द
Mukut	मुकुट
Mula	मुला
Mule	मुले
Mulgaonkar	मुलगावकर
Mulla	मुल्ला
Mullally	मुलाली
Mulshi	मुल्शी
Mumbai	मुंबई
Mumbai	मुम्बई
Mumeen	मुमीन
Mumkin	मुमकिन
Mummy	मम्मी
Mun	मुन
Munasinghe	मनुसिंघे
Mundra	मुंदडा
Muneeb	मुनीब
Muneesh	मुनीश
Mungekar	मुंगेकर
Muni	मुनि
Munich	मुनिच
Munich	म्यूनिच
Munimji	मुनीमजी
Munis	मुनीस
Munjal	मुंजल
Munkadir	मुन्कदिर
Munro	मुनरो
Muntaqim	मुंतकिम
Muntasir	मुंतासिर
Muntasir	मुंतसिर
Munzir	मुंजीर
Muqaddas	मुकद्दस
Muqit	मुकीत
Muraina	मुरैना
Muralee	मुरली
Murali	मुरली
Murde	मुर्दे
Murderer	मर्डरर
Murdiyya	मुर्दिया
Muriel	म्युरिएल
Murlin	मर्लिन
Murphy	मुर्फी
Murphy	मर्फी
Murray	मुर्रे
Mursal	मुरसल
Murshid	मुर्शीद
Murti	मूर्ति
Murugan	मुरूगन
Murugappa	मुरूगप्पा
Musem	म्युजियम
Museon	म्युजिअन
Musharraf	मुशर्रफ
Musheer	मुशीर
Mushtaak	मुश्ताक
Mushtaq	मुश्ताक
Muskai	मुस्काई
Muskan	मुस्कान
Muslim	मुस्लिम
Mussoorie	मसूरी
Mustaeenah	मुस्ताईनाह
Mustahsan	मुस्तहसन
Mustaneer	मुस्तनीर
Mutaalee	मुताली
Mutasim	मुतासिम
Mutatkar	मुटाटकर
Mutazah	मुताजाह
Mutendera	मुतेन्देरा
Mutha	मुठा
Muthi	मुट्ठी
Muti	मुती
Mutneja	मुटनेजा
Mutsu	मत्सू
Muttiah	मुथैया
Muzakkir	मुजक्किर
Muzzammil	मुज्जम्मिल
Myer	मैर
Myers	मेयर्स
Myron	मायरॉन
Mysore	मैसूर
Naach	नाच
Naagachanpaa	नागचंपा
Naari	नारी
Naatak	नाटक
Nabi	नबी
Nabihah	नबीहाह
Nabilah	नबीलाह
Nachegi	नाचेगी
Nachiyar	नाचियार
Nadal	नडाल
Nadalia	नाडलिआ
Nadalo	नडालो
Nadine	नाडिने
Nadine	नादिन
Nadiyah	नादिया
Nadr	नद्र
Naeem	नईम
Naeva	नएवा
Nafade	नाफडे
Nafee	नफी
Nafiah	नफीयाह
Nafisah	नफीसा
Nafrat	नफरत
Nagama	नगमा
Naganand	नागानंद
Nagari	नगरी
Nagasaki	नागासाकी
Nagato	नगेटो
Nagin	नागिन
Naginder	नगिन्दर
Nagma	नगमा
Nagpal	नागपाल
Nagpur	नागपुर
Nagri	नगरी
Nahanni	नाहान्नी
Nahar	नाहर
Nai	नई
Nai	नाइ
Naib	नैब
Naiduniya	नईदुनिया
Naifah	नैफा
Nail	नेल
Naim	नैम
Naimish	नैमिश
Naimur	नइमुर
Nain	नैन
Naina	नैना
Naismith	नायस्मिथ
Najdah	नज्दाह
Najih	नजीह
Najwa	नज्वा
Naka	नाका
Nakesh	नकेश
Nakhat	नखत
Nakhre	नखरे
Nakshatra	नक्षत्र
Nakul	नकुल
Nalanda	नालन्दा
Nalavade	नलावडे
Nalayak	नालायक
Nalco	नाल्को
Nalin	नलिन
Nallur	नल्लुर
Nalvadi	नलवाडी
Namaste	नमस्ते
Nambardar	नंबरदार
Namchi	नामची
Namita	नमिता
Namoona	नमुना
Namrata	नम्रता
Namur	नामुर
Nanad	ननद
Nanakmata	नानकमता
Nancy	नैन्सी
Nanda	नंदा
Nanda	नन्दा
Nandakishor	नंदकिशोर
Nandan	नन्दन
Nandana	नन्दना
Nandini	नंदिनी
Nandini	नन्दिनी
Nandur	नन्दूर
Nandurkar	नांदुरकर
Nanette	ननेटे
Nanha	नन्हा
Nani	नानी
Nanjing	नंजिंग
Nanotechnologies	नैनोटेकर्नलॉजिस
Naomi	नाओमी
Napa	नैपा
Naparajit	नपराजित
Naples	नेपेल्स
Napoleon	नेपोलियन
Naqi	नकी
Naqqash	नक्काश
Narahari	नरहरि
Naram	नरम
Nardo	नार्डो
Naresh	नरेश
Nari	नारी
Narkar	नारकर
Narmad	नर्मद
Narrows	नॅरोज
Narsi	नरसी
Narsingh	नरसिंह
Nartaki	नर्तकी
Nasa	नासा
Nasbandi	नसबंदी
Naseen	नसीन
Nash	नेश
Nasha	नशा
Nashaa	नशा
Nashit	नाशित
Nashitah	नशीता
Nashtari	नश्तरी
Nashwa	नश्वा
Nashwaak	नैशवाक
Nasia	नासिया
Nasik	नासिक
Nasikakar	नाशिककर
Nasim	नसीम
Nasir	नासीर
Nasir	नासिर
Nasiruddin	नसीरूद्दीन
Naspers	नैस्पर्स
Nasr	नस्र
Nasrin	नसरीन
Nast	नास्त
Natali	नताली
Natesh	नतेश
Nathalie	नैथले
Native	नेटिव
Natrona	नैट्रोना
Natura	नैच्युरा
Naubahar	नौबहार
Naugaon	नऊगाव
Naughty	नॉटी
Naukar	नौकर
Naukari	नौकरी
Naushad	नौशाद
Navakrashn	नवकृष्ण
Naval	नवल
Navare	नवरे
Naved	नावेद
Naveed	नावीद
Naveen	नवीन
Navendra	नवेंद्र
Navneet	नवनीत
Navrang	नवरंग
Nawab	नवाब
Nawal	नवल
Nayab	नायाब
Nayagarh	नयागड
Naye	नये
Nayee	नई
Nazakat	नजाकत
Nazaria	नजरिया
Nazeef	नजीफ
Nazeer	नजीर
Nazih	नजीह
Nazima	नाजिमा
Nazir	नाजीर
Nazneen	नाजनीन
Ne	ने
Neblina	नेबलिना
Nebula	नेब्युला
Nebula	नेब्यूला
Neck	नेक
Nederlanden	नीदरलैंडन
Nedra	नेड्रा
Neeche	नीचे
Neeladri	नीलाद्री
Neelakshi	नीलाक्षी
Neelanjan	नीलांजन
Neelgiri	नीलगिरी
Neelkanthdham	नीलकंठधाम
Neeraf	नीरफ
Neeraja	नीरजा
Nefous	नेफोस
Negi	नेगी
Nehal	नेहल
Nehar	नहर
Neil	नील
Nek	नेक
Nelia	नेलिया
Nellis	नेलीस
Nemmers	नेमर्स
Nene	नेने
Neodymium	नीयोडिमियम
Neptune	नेपच्यून
Nero	नेरो
Nerolac	नेरोलेक
Nestle	नेस्टले
Nestlé	नैस्ले
Netball	नेटबॉल
Netherlands	नीदरलैंड्स
Netra	नेत्रा
Neumann	न्युमेन
Neurochem	न्यूरोकेम
Nevado	नेव्हाडो
Newberg	न्यूबर्ग
Newman	न्यूमैन
Newspaperss	न्युजपेपर्स
Newsprint	न्यूज़प्रिंट
Newton	न्यूटन
Niaz	नियाज
Niblett	निब्लेट
Nicholas	निकोलस
Nicholson	निकॉल्सन
Nicholson	निकोलसन
Nicki	निक्की
Nicole	निकोल
Nicolette	निकोलेट
Nidhi	निधी
Nidhish	निधीश
Nieuwe	निउवे
Nigahen	निगाहे
Nigam	निगम
Nigel	निगेल
Niger	नाइजर
Nihal	निहाल
Nihang	निहंग
Nihar	निहार
Niharika	निहारिका
Nijjar	निज्जर
Nikhil	निखिल
Nikhilesh	निखिलेश
Nikkos	निक्कोस
Nikunj	निकुंज
Nila	नीला
Nilantha	निलंथा
Nileen	निलीन
Nimana	निमाणा
Nimish	निमिश
Ninetowns	नाइनटाउन्स
Niobium	नियोबियम
Nippon	निप्पॉन
Nirala	निराला
Nirali	निराली
Niramay	निरामय
Niranjana	निरंजना
Nirbhay	निर्भय
Nirmaan	निर्माण
Nirmohi	निर्मोही
Niroshan	निरोशन
Nisa	निसा
Nischal	निश्चल
Nisha	निशा
Nishaan	निशान
Nishan	निशान
Nishana	निशाना
Nishit	निशीत
Nishith	निशीथ
Nishtha	निष्ठा
Nishvan	निश्वान
Nithar	निथार
Nitrogen	नाइट्रोजन
Nitsa	नित्सा
Nityagopal	नित्यगोपाल
Nityanand	नित्यानन्द
Nityapriya	नित्यप्रिया
Nivritti	निवृत्ति
Nizambad	निजामबाद
Nizamuddin	निजामुद्दीन
No	नो
Nobelium	नॉबेलियम
Noel	नोएल
Nogait	नोगाइट
Noguchi	नोगुची
Noida	नोएडा
Nokia	नोकिया
Nola	नोला
Noma	नोमा
Nona	नोना
Nooh	नूह
Noori	नूरी
Noorie	नूरी
Noorjahan	नूरजहान
Nora	नोरा
Norah	नोरह
Norbert	नॉबर्ट
Norbert	नॉरबेर्ट
Nordiska	नॉरडिस्का
Norm	नॉर्म
Norman	नॉर्मेन
Normandie	नॉर्मेन्डी
Normandy	नोरमैंडी
Noronha	नॉरोन्हा
Norris	नॉरिस
North	नार्थ
Northrop	नॉर्थ
Norwood	नारवुड
Nousher	नौशर
Novatel	नॉवएटेल
Novo	नोवो
Noyyal	नोय्यल
Nripendra	नृपेंद्र
Numbari	नंबरी
Numbri	नंबरी
Numismatic	न्यूमिस्मेटिक
Nuncio	नुंकिओ
Nurek	न्युरेक
Nursing	नर्सिंग
Nurul	नुरुल
Nurway	न्यूरवे
Nusrat	नुसरत
Nutzotin	नुटजोटिन
Nuwan	नुवान
Nuzhat	नुज्हत
Nyika	न्याइका
Oakley	ऑकले
Oalkar	ओलकर
Oarathuppalayam	ऑराथुप्पलयम
Obayashi	ओबयाशी
Obban	ओब्बन
Obie	ओबि
Obuya	ओबुया
Oconnor	ऑकोनॉर
October	ऑक्टोबर
Oda	ओदा
Odai	ओदई
Odai	ओदाई
Odelia	ओडेलिआ
Oder	ओडेर
Odina	ओडिना
Odyssey	ऑडीसी
Of	ऑफ
Offensive	ओफेंसिव
Office	ऑफिस
Ogan	ओगन
Ogden	ओग्डेन
Ogle	ओगले
Ohio	ओहियो
Oil	ऑइल
Oil	ऑईल
Ojaswini	ओजस्विनी
Okanogan	अकानोगन
Okhotsk	ओखोत्स्क
Okinoshima	ओकिनोशिमा
Oklahoma	ओक्लाहोमा
Olav	ओलव
Old	ओल्ड
Oldenberg	ऑडेनबर्ग
Olive	ओलिव
Olivier	ओलिविअर
Olkhon	ओल्खान
Olmstead	ऑलम्स्टीड
Olsen	ऑल्सेन
Olympia	ओलिम्पिया
Oman	ओमान
Omani	ओमनी
Omar	ओमर
Omar	ओमार
Omari	ओमारी
Omax	ओमेक्स
Omega	ओमेगा
Omeshvar	ओमेश्वर
Omswaroop	ओमस्वरूप
Ona	ओना
Onassis	ओनासिस
Oncolytics	ऑनकोलिटिक्स
One	वन
Onella	ओनेला
Only	ओनली
Ono	ओनो
Ontaze	ओन्ताजे
Ontong	ओंटॉन्ग
Onyango	ओन्यैंगो
Oona	ऊना
Oonche	ऊंचे
Ooperwala	ऊपरवाला
Oorderen	उर्डेरेन
Oorjit	ऊर्जित
Oos	उस
Ootacamund	ऊटाकमुंड
Opatha	ओपाथा
Open	ओपन
Opera	ओपेरा
Ophelia	ओफेलिया
Ophthalmology	ऑपथैल्मोलॉजी
Opra	ऑपरा
Optic	ऑप्टिक
Optical	ऑप्टिकल
Optimal	ऑप्टीमल
Opto	ऑप्टो
Oracle	ओरेकल
Oral	ऑरल
Oral	ओरल
Orbison	ऑर्बीसन
Orchards	ऑर्चर्ड्स
Ord	ऑर्ड
Orden	ऑर्डेन
Order	ऑडर
Order	ऑर्डर
Ore	ओरे
Org	ऑर्ग
Orgaos	ऑरगाओस
Oriana	ओरिआना
Oriental	ओरिएंटल
Orinoco	ऑरिनॉको
Orinoco	ओरिनोको
Orion	ओरियन
Oriya	ओरिया
Orizaba	ओरीजाबा
Ormand	ओर्मंड
Orrin	ओरीन
Orteig	ऑर्टेग
Orthopaedics	ओर्थोपेडिक्स
Ortiz	ऑर्टिज
Oscar	ऑस्कर
Osimam	ओसिमाम
Oslo	ऑस्लो
Osman	ओस्मान
Osmanabad	उस्मानाबाद
Osment	ऑसमेंट
Osric	ओसरिक
Ossie	ओसी
Ostfriesland	ऑस्टफ्रिएसलैंड
Otis	ओटिस
Otranto	ओट्रांटो
Otto	ओट्टो
Ourra	औरा
Outstanding	आउटस्टैंडिंग
Ovcharska	ओवचारस्का
Over	ओवर
Overseas	ओवरसिस
Overseas	ओवरसीस
Owena	ओवेना
Owens	ऑवेंस
Owl	ऑव्ल
Oxford	ऑक्सफोर्ड
Oxford	ओक्सफोर्ड
Ozak	ओजाक
Paachanee	पाचनी
Paachpore	पाचपोरे
Paage	पागे
Paap	पाप
Paaras	पारस
Paaro	पारो
Paarvatee	पार्वती
Paatekar	पाटेकर
Pabla	पाब्ला
Pable	पाब्ले
Pacific	पॅसिफिक
Pacific	पेसिफक
Pacific	पेसिफिक
Pacific	पैसिफिक
Pacino	पचिनो
Packwood	पैकवुड
Pada	पाडा
Padam	पदम
Padayani	पडायनी
Padhye	पाध्ये
Padmalaya	पद्मालय
Padmalaya	पद्मालया
Padmanabh	पद्मनाभ
Padmanabhan	पद्मनाभन
Padmavati	पद्मावती
Padosan	पडोसन
Pahadi	पहाडी
Paharpur	पहारपुर
Paharpur	पाहरपुर
Pahechan	पहचान
Paheli	पहेली
Pahelwan	पहलवान
Pahla	पहला
Pahli	पहली
Pahunche	पहुँचे
Paige	पैगे
Paighaam	पैगाम
Paigham	पैगाम
Paine	पेन
Painleve	पेनलीव
Paints	पेंट्स
Pair	पैर
Paisa	पैसा
Paisley	पैस्ले
Pakaraima	पाकाराइमा
Pakhowalia	पखोवालिया
Pakistan	पाकिस्तान
Pakshi	पाक्षी
Pakshiraj	पक्षीराज
Palestro	पैलेस्ट्रो
Paley	पले
Palframan	पैल्फ्रेमन
Palken	पलके
Palki	पालकी
Palkon	पलको
Pallab	पल्लब
Pallav	पल्लव
Pallington	पैलिंगटन
Pamir	पामीर
Pamposh	पंपोश
Pampus	पैम्पस
Pan	पैन
Panavin	पनविन
Panch	पाच
Panchkula	पंचकुला
Panchmahal	पंचमहल
Panchvati	पंचवटी
Panchwin	पाचवी
Pandav	पांडव
Pandhari	पंढरी
Pandher	पंढेर
Panditji	पंडितजी
Pandora	पैंडोरा
Pandurang	पांडुरंग
Panduranga	पांडुरंग
Panetti	पैनेटी
Pani	पानी
Panji	पणजी
Pankhi	पंखी
Pannu	पन्नु
Panse	पानसे
Pant	पंत
Pantaloon	पैंटालून
Panthea	पैंथिया
Paola	पाओला
Paolo	पाओलो
Pape	पेप
Paper	पेपर
Papi	पापी
Paprika	पैप्रिका
Papua	पापुआ
Paradkar	पराडकर
Paraguayan	पैरागुएन
Parakram	पराक्रम
Paramarth	परमार्थ
Parambikulam	परम्बिकुलम
Paramhansa	परमहंस
Paranjape	परांजपे
Paras	पारस
Parashuram	परशुराम
Paravej	परवेज
Paraye	पराए
Parchhaiyan	परछाइया
Parda	पर्दा
Paree	परी
Pareeksha	परीक्षा
Paresh	परेश
Pargana	परगना
Pari	परी
Parichay	परिचय
Paricutin	परिक्युटिन
Parihan	परिहन
Parihar	परिहार
Pariket	पारिकेत
Parimal	परिमल
Parinde	परिंदे
Parindra	परिंद्रा
Paritosh	पारितोष
Parivartan	परिवर्तन
Pariwar	परिवार
Parker	पार्कर
Parkway	पार्कवे
Parma	पार्मा
Parmameshwar	परमेश्वरी
Parolkar	पारोलकर
Parry	पेरी
Parry	पैरी
Parthasarathi	पार्थसारथी
Parthasarthi	पार्थसार्थी
Party	पार्टी
Parul	पारुल
Parvin	परवीन
Pasand	पसंद
Pashcim	पश्चिम
Pashupati	पशुपति
Passing	पासिंग
Passport	पासपोर्ट
Pasternek	पास्तरनेक
Pataal	पाताल
Patale	पटाले
Patan	पतन
Patch	पैच
Pate	पाते
Pathak	पाठक
Patharon	पत्थरो
Pathik	पथिक
Pathology	पैथोलोजी
Pathway	पाथवे
Patiala	पटियाला
Patil	पाटिल
Patjhad	पतझड
Patki	पत्की
Patni	पटनी
Patni	पत्नी
Patra	पत्र
Patricia	पैट्रीसिया
Patsy	पैट्सी
Pattey	पत्ते
Patthar	पत्थर
Pattharon	पत्थरो
Patti	पट्टी
Patto	पत्तों
Paulette	पोलेत
Pauli	पॉली
Paulina	पौलिना
Pauline	पौलिने
Paull	पॉल
Paulo	पॉलो
Paulos	पोलस
Pavak	पावक
Pavamaan	पवमान
Pavanaputr	पवनपुत्र
Pavitr	पवित्र
Pavitra	पवित्र
Pawagi	पावगी
Pawana	पवाना
Payal	पायल
Payoja	पयोजा
Paz	पाज
Pe	पे
Peabody	पीबॉडी
Peall	पील
Pearl	पर्ल
Pearly	पर्ली
Pearse	पियर्स
Peary	पियरे
Pechiparai	पेचीपराई
Peckover	पेकोवर
Peder	पेडर
Pedro	पेड्रो
Peechha	पीछा
Peelaa	पीला
Peer	पीर
Pegasus	पेगासस
Pehchan	पहचान
Pehli	पहली
Peixe	पैक्स
Peking	पेकिंग
Pello	पेल्लो
Pelly	पेल्ली
Pemex	पेमेक्स
Pendse	पेंडसे
Penh	पेन्ह
Peninsula	पेनिनसुला
Peninsula	पेनिन्सुला
Pennie	पेनी
Pensioner	पेंशनर
Pentasoft	पेन्टासॉफ्ट
Pepperrell	पेपेरेल
Per	पर
Percell	पेर्सेल
Perchrock	परक्रॉक
Percival	पेर्किवल
Percy	पेर्सी
Periyar	पेरियार
Perot	पेरॉट
Perry	पेरी
Perumal	पेरूमाल
Perumpallam	पेरुमपल्लम
Peruvaripallam	पेरुवरीपल्लम
Pervez	परवेज
Peso	पेसो
Pethkar	पेठकर
Petra	पेत्रा
Petroleum	पेट्रोलियम
Petronella	पेत्रोनेला
Petula	पेटुला
Peugeot	प्यूजियट
Phadnis	फडनीस
Phaedra	फेद्रा
Phalke	फालके
Phanda	फंदा
Phande	फंदे
Phanindra	फणिंद्र
Phansi	फांसी
Pharma	फार्मा
Pharmaceuticals	फार्मासुटिकल्स
Pharmaceuticals	फार्मास्युटिकल्स
Pharmaxis	फार्माक्सिस
Phek	फेक
Philana	फिलना
Philantha	फिलांथा
Philatelic	फिलाटेलिक
Philena	फिलेना
Philippine	फिलिपायन
Philippine	फिलीपाइन
Philippine	फिलीपीन
Philips	फिलिप्स
Phillip	फिलिप
Philosophy	फिलोसोफी
Phir	फिर
Phoebe	फोएबे
Phoenix	फोनिक्स
Phosphorus	फॉस्फोरस
Phule	फुले
Phyliss	फिलिस
Phyllis	फिलिस
Piastres	पायस्ट्रेस
Picasso	पिकासो
Pico	पिको
Pierres	पिरेस
Pieter	पीटर
Pietersen	पीटरसन
Pighalta	पिघलता
Pike	पाइक
Pilpili	पिलपिली
Pimpalkhare	पिंपलखरे
Pinault	पिनॉल्ट
Ping	पिंग
Pingala	पिंगला
Pinge	पिंगे
Pinjre	पिंजरे
Pinson	पिंसन
Pinta	पिंटा
Pioneers	पायोनियर्स
Pipe	पाइप
Pipe	पाईप
Pipes	पाइप्स
Pirama	पिरामल
Pitamah	पितामह
Pitampura	पितमपुरा
Pival	पिवल
Piya	पिया
Piyush	पीयुष
Piyush	पीयूष
Placido	प्लैसिडो
Plainfield	प्लेनफिल्ड
Plateau	प्लेट्यू
Platinum	प्लेटिनम
Players	प्लेयर्स
Playwin	प्लेविन
Plunkett	प्लंकेट
Pluto	प्लूटो
Plutonium	प्लूटोनियम
Plymouth	प्लायमाउथ
Pochiah	पोचिआह
Pocock	पॉकॉक
Pocono	पॉकॉनो
Poe	पो
Poe	पोय
Poetry	पोएट्री
Poets	पोएट्स
Point	पॉइंट
Point	पॉईंट
Pointer	पॉइंटर
Poland	पोलैंड
Polar	पोलर
Polaris	पोलरीस
Police	पोलिस
Polish	पॉलिश
Polonia	पोलोनिया
Polyplex	पॉलीप्लेक्स
Polytechnic	पॉलीटेक्निक
Pondera	पॉन्डेरा
Pondicherry	पॉडीचेरी
Ponnaniar	पॉनानियर
Pont	पॉन्ट
Poojan	पूजन
Pools	पूल्स
Poonam	पूनम
Pophalikar	पोफलीकर
Popham	पॉफैम
Popton	पॉपटन
Porte	पोर्ट
Portland	पोर्टलंड
Portland	पोर्टलैंड
Porto	पोर्टो
Portogallo	पॉर्टोगैलो
Portsmouth	पोर्ट्‍समाउथ
Portugal	पोर्तुगाल
Posco	पॉस्को
Poshakhwale	पोषाखवाले
Post	पोस्ट
Potassium	पॉटेशियम
Potemkin	पॉटेमकिन
Pothohar	पोठोहर
Pothohari	पोठोहारी
Pour	पॉर
Poushali	पौशाली
Powar	पोवार
Powerful	पावरफुल
Prabha	प्रभा
Prabhaa	प्रभा
Prabhas	प्रभास
Prabhjot	प्रभजोत
Prabhsimran	प्रभसिमरन
Prabhu	प्रभु
Prabhuraam	प्रभुराम
Prabir	प्रबीर
Prabodhan	प्रबोधन
Pradesh	प्रदेश
Prafuti	प्रफुती
Pragathi	प्रगती
Pragati	प्रगती
Pragyaparamita	प्रज्ञापरमिता
Prahas	प्रहास
Prahlaad	प्रह्लाद
Prahlad	प्रह्लाद
Praj	प्राज
Praja	प्रजा
Prajasrij	प्रजासृज
Prajeet	प्रजीत
Prajin	प्रजिन
Prakaash	प्रकाश
Pralay	प्रलय
Pramila	प्रमिला
Pranjivan	प्राणजीवन
Pransukh	प्राणसुख
Prasad	प्रसाद
Prasann	प्रसन्न
Praseodymium	प्रेसियोडीमियम
Prashant	प्रशांत
Prashanti	प्रशांती
Prasoon	प्रसून
Pratapgarh	प्रतापगड
Prathi	प्रथी
Pratigya	प्रतिज्ञा
Pratik	प्रतीक
Praveen	प्रवीण
Pravin	प्रवीण
Prayag	प्रयाग
Prayashchit	प्रायश्चित
Prayer	प्रेअर
Precision	प्रिसिजन
Precision	प्रिसिशन
Precision	प्रीसिशन
Preeti	प्रीति
Prem	प्रेम
Premala	प्रेमला
Premaprakaash	प्रेमप्रकाश
Premchand	प्रेमचंद
Presbyterian	प्रेसबिटेरियन
Presbyterian	प्रेस्बिटेरिअन
Presbyterian	प्रेस्बिटेरियन
Presidency	प्रेसिडेंसी
Presley	प्रिस्ली
Presley	प्रीस्ले
Price	प्राइस
Priestley	प्रीस्टले
Princess	प्रिंसेस
Princeton	प्रिंसेटन
Pringle	प्रिंगल
Prior	प्रायर
Prisca	प्रिस्का
Priscilla	प्रिस्किला
Prism	प्रिज्म
Prithvi	पृथ्वी
Prithviraj	पृथ्वीराज
Priyadarshini	प्रियदर्शिनी
Priyanka	प्रियंका
Priyatma	प्रियतमा
Processing	प्रोसेसिंग
Procter	प्रॉक्टर
Products	प्रोडक्ट्स
Proffitt	प्रोफिट
Progen	प्रोजेन
Progeon	प्रोजेन
Progressive	प्रोग्रेसिव
Projects	प्रोजेक्ट्स
Prokofiev	प्रोकोफीव
Prometheus	प्रोमिथेउस
Propack	प्रोपेक
Prospect	प्रॉस्पेक्ट
Prudence	प्रुडेंस
Prussian	प्रुसियन
Pryor	प्रयॉर
Psaltery	साल्टरी
Psychiatry	साइकेट्री
Pub	पब
Public	पब्लिक
Pudhari	पुढ़ारी
Pugree	पगडी
Pui	पुई
Pujarin	पुजारिन
Pukara	पुकारा
Pukaskwa	पुकास्कवा
Pulak	पुलक
Pulakit	पुलकित
Puloma	पुलोमा
Pulwama	पुलवामा
Punarnava	पुनर्नवा
Pundarik	पुन्डरीक
Punjokhara	पंजोखरा
Purbi	पूर्बी
Purbrook	परब्रूक
Purdue	पर्डयु
Purity	प्युरिटी
Purnanad	पूर्णनाद
Purnima	पुर्णिमा
Purumitra	पुरुमित्र
Purus	प्युरस
Purushottam	पुरुषोत्तम
Pushkal	पुष्कल
Pushpak	पुष्पक
Pushpanjali	पुष्पांजली
Pushpeshu	पुष्पेशु
Putli	पुतली
Putul	पुतुल
Pyaara	प्यारा
Pyaasa	प्यासा
Pyaasi	प्यासी
Pyar	पानी
Pyar	प्यार
Pyara	प्यारा
Pyaremohan	प्यारेमोहन
Pyari	प्यारी
Pyasa	प्यासा
Pycroft	पाइक्रोफ्ट
Pydanna	पायडैना
Qadeer	कादीर
Qadir	कादीर
Qahhar	कहार
Qaiyoum	काययोउम
Qalander	कलंदर
Qalat	कलात
Qamayr	कमायर
Qamra	कामरा
Qani	कानी
Qaniah	कनियाह
Qaraah	कराह
Qarasafahl	करासफाहल
Qareebah	करीबाह
Qaseem	कसीम
Qasoomah	कसूमाह
Qatil	कातिल
Qawwali	कव्वाली
Qayamat	कयामत
Qaylah	कयलाह
Qaymayriyah	कायमयरियाह
Qayyoom	कय्यूम
Qiagen	क्विएजन
Quadrille	क्वाड्रिल
Quaid	काइद
Quaidi	कैदी
Quanta	क्वांटा
Quddus	कुद्दुस
Quddusiyyah	कुद्दुसियाह
Queen	क्वीन
Queenie	क्वीनी
Quentin	कुएंतिन
Quetzal	क्वेटजल
Quickstep	क्विकस्टेप
Quintana	क्विंटाना
Quintana	क्वींटाना
Quintessa	क्विंटेसा
Quitaiplas	क्विटायप्लस
Quran	कुरान
Qurban	कुर्बान
Qurratul	कुर्रतुल
Qusay	कुसय
Qutb	कुत्ब
Qutbuddin	कुतबुद्दीन
Raada	राडा
Raadheshyaam	राधेश्याम
Raadhikaa	राधिका
Raag	राग
Raageshwari	रागेश्वरी
Raaghav	राघव
Raagini	रागिनी
Raahen	राहें
Raaj	राज
Raajakumaar	राजकुमार
Raajakunvar	राजकुंवर
Raajamuni	राजमुनि
Raajesh	राजेश
Raajit	राजीत
Raakesh	राकेश
Raakhee	राखी
Raakhi	राखी
Raamacharan	रामचरण
Raamasakhaa	रामसखा
Raamavilaas	रामाविलास
Raameshvar	रामेश्वर
Raan	रान
Raana	राणा
Raanchi	रांची
Raane	राणे
Raani	रानी
Raashi	राशि
Raaste	रास्ते
Raat	रात
Raavan	रावण
Rabab	रबाब
Rabat	रबात
Rabia	राबिया
Rabindranath	रबीन्द्रनाथ
Rabit	रेबिट
Rabitah	रबिताह
Rachana	रचना
Rachelle	रशेल
Radhakrishna	राधाकृष्ण
Radhesh	राधेश
Radheshyam	राधेश्याम
Radi	रादी
Radica	रेडिका
Radico	रैडिको
Radley	रेडली
Radley	रैडले
Radon	रेडॉन
Rae	रे
Raeanne	रेनी
Raeeszada	रईसजादा
Rafael	रैफल
Rafee	रफी
Rafeeqah	रफीकाह
Rafi	रफी
Rafiq	रफीक
Rafique	रफीक
Rafting	राफ्टिंग
Rafto	रैफ्टो
Raghavendra	राघवेंद्र
Raghib	रघीब
Raghibah	रगीबाह
Raghu	रघु
Raghukul	रघुकुल
Raghunaath	रघुनाथ
Raghunandan	रघुनन्दन
Raghuraaee	रघुराई
Ragini	रागिनी
Raha	रहा
Raha	राहा
Rahaman	रहमान
Rahe	रहे
Raheem	रहीम
Rahen	राहे
Rahi	रही
Rahila	रहीला
Rahim	रहीम
Rahmaan	रहमान
Rahmat	रहमत
Rahnuma	रहनुमा
Rahole	राहोल
Rahoongi	रहूँगी
Rahungi	रहूंगी
Raidah	रैदाह
Raigad	रायगड
Rail	रेल
Raiseni	रायसेनी
Raitah	रैताह
Raja	राजा
Rajagopalachari	राजगोपालाचारी
Rajam	राजम
Rajaneekar	रजनीकर
Rajanigandha	रजनीकांत
Rajanikant	रजनीकांत
Rajasmand	राजसमंद
Rajdhani	राजधानी
Rajdulara	राजदुलारा
Rajdulari	राजदुलारी
Raje	राजे
Rajendra	राजेंद्र
Rajendra	राजेन्द्र
Rajeshwari	राजेश्वरी
Rajgarh	राजगड
Rajiv	राजीव
Rajkumar	राजकुमार
Rajouri	राजौरी
Rajpal	राजपाल
Rajputani	राजपुतानी
Rajshri	राजश्री
Raju	राजू
Rajya	राज्य
Rakh	राख
Rakhda	रखडा
Rakhwala	रखवाला
Rakhwale	रखवाले
Raksha	रक्षा
Rakshak	रक्षक
Ralph	राल्फ
Ram	राम
Ramadhip	रमाधिप
Ramaia	रमैया
Ramakant	रमाकांत
Ramakrishna	रामकृष्ण
Ramandeep	रमनदीप
Ramaneek	रमणीक
Ramani	रमणी
Ramani	रमानी
Ramanuj	रामानुज
Ramapo	रामपो
Ramappa	रामप्पा
Ramashray	रामाश्रय
Ramavatar	रामावतर
Rambaan	रामबाण
Ramchandr	रामचंद्र
Rameshwaram	रामेश्वरम
Ramgadia	रामगडीया
Ramgopal	रामगोपाल
Rami	रामी
Ramirez	रमीरेज
Ramiro	रमिरो
Ramish	रमिश
Ramjoshi	रामजोशी
Ramkali	रामकली
Ramnaresh	रामनरेश
Ramnarine	रामनारायण
Ramnath	रामनाथ
Ramon	रामोन
Ramprakash	रामप्रकाश
Ramsar	रामसर
Ramya	रम्या
Ran	रण
Ranakpur	रणकपुर
Ranasinghe	राणासिंघे
Ranatunga	राणातुंगा
Ranchandi	रणचंडी
Ranchod	रेंचड
Randall	रैंडल
Randall	रैंडाल
Randgold	रैंडगोल्ड
Randy	रैंडी
Ranee	रानी
Ranesh	रणेश
Rang	रंग
Rangan	रंगन
Ranganath	रंगनाथ
Rangila	रंगीला
Rangoon	रंगून
Ranjan	रंजन
Ranjana	रंजना
Ranjanee	रंजनी
Ranjith	रंजीथ
Ranks	रैंक्स
Raonar	राओनर
Rapti	राप्ती
Rapughan	रपुघन
Raqeeb	रकीब
Raqib	रकीब
Raquetball	रैकेटबॉल
Rasaal	रसाल
Rasavant	रसवंत
Rasbihari	रासबिहारी
Rasheed	रशीद
Rashida	रशीदा
Rashinkar	राशिनकर
Rashmika	रश्मिका
Rashmil	रश्मिल
Rashtraveer	राष्ट्रवीर
Rasia	रेसिया
Rasili	रसीली
Raspberry	रस्पबेरी
Rasta	रास्ता
Raste	रास्ते
Rasul	रसूल
Ratanalaal	रतनलाल
Rate	रेट
Raten	राते
Rathan	रथन
Rathapati	रथपती
Rati	रती
Ratia	रतिया
Ratna	रत्ना
Ratnaakar	रत्नाकर
Ratnabala	रत्नबाला
Ratnabali	रत्नबाली
Ratnajyouti	रत्नज्योति
Ratnali	रत्नाली
Ratnamala	रत्नमाला
Ratnangi	रत्नांगी
Ratnaprabha	रत्नप्रभा
Ratnapriya	रत्नप्रिया
Ratnavali	रत्नावली
Ratnayake	रत्नायके
Ratnesh	रत्नेश
Raton	राटॉन
Raton	रातो
Rattu	रत्तु
Ratu	रतु
Rauf	रऊफ
Rauf	रौफ
Raveesh	रवीश
Raverkar	रावेरकर
Ravidas	रविदास
Ravipriy	रविप्रिय
Ravish	रविश
Ravishankar	रविशंकर
Rawa	रावा
Rawahah	रवाहाह
Rawlins	रॉलिंस
Rawson	रॉसन
Ray	रे
Raya	राया
Raynold	रेनॉल्ड
Raytheon	रेथिऑन
Raza	रजा
Razdan	राजदान
Razia	रजिया
Razzaq	रज्जाक
Re	रे
Rea	रिया
Read	रीड
Reading	रीडिंग
Reba	रीबा
Rebaba	रेबाबा
Recovery	रिकवरी
Red	रेड
Redeemer	रिडीमर
Redevelopment	रीडेवलेपमेंट
Redmond	रेडमंड
Redoubt	रिडाउट
Redoubt	रीडाउट
Redoutable	रेडॉटेबल
Reece	रीस
Reed	रीड
Reedsport	रेडस्पोटर्स
Reen	रीन
Reetaa	रीता
Reetinder	रीतिंदर
Reformed	रिफॉर्मेड
Refugee	रेफ्युजी
Reghe	रेघे
Rehana	रेहाना
Rehman	रहमान
Rehman	रेहमान
Reibel	रीबल
Reid	रैड
Reinsurance	रीइंश्योरेंस
Rekha	रेखा
Rekhaa	रेखा
Relativity	रिलेटिविटी
Reliance	रिलायंस
Remington	रेमिंग्टन
Renault	रीनॉल्ट
Rendor	रेंडर
Renguzar	रैनगुजर
Reno	रेनो
Reporter	रिपोर्टर
Republic	रिपब्लिक
Reque	रेक
Rescue	रेसक्यु
Reservoir	रिजरवायर
Reservoirs	रिजरवायर
Resham	रेशम
Reshmi	रेशमी
Resources	रिसोर्सेज
Resurrection	रीसुरेक्शन
Ret	रेत
Revolution	रिवॉल्युशन
Revolution	रिवॉल्यूशन
Revolutionary	रिवॉल्यूशनरी
Rewa	रीवा
Rewadikar	रेवाडीकर
Rex	रेक्स
Rexheb	रेक्सहेब
Reykjavik	रैक्जविक
Reynard	रेनार्ड
Reynolds	रेनॉल्ड्स
Rhea	र्‍हिया
Rheinland	रेनलैंड
Rhian	र्‍हिआन
Rhoda	रोडा
Rhodes	रोड्स
Rhona	र्‍होना
Rialto	रीआल्टो
Rianne	रियान्नी
Rica	रिका
Richard	रिचर्ड
Richards	रिचर्ड्स
Richelle	रिशेल
Richie	रिची
Richie	रिशी
Rico	रिको
Riddhiman	ऋद्धिमान
Ridge	रिज
Ridley	रिडले
Rifaah	रिफाह
Rifai	रिफाई
Riffa	रिफा
Rifle	राइफल
Rigg	रिग
Riju	ऋजु
Rikki	रिक्की
Rima	रीमा
Rindel	रिंडल
Ringhe	रिंघे
Rinku	रिंकु
Rino	रीनो
Rio	रिओ
Rio	रियो
Riona	रियोना
Risa	रीजा
Rishika	ऋषिका
Rishikesh	ऋषिकेश
Rishta	रिश्ता
Rishtaa	रिश्ता
Rising	राइसिंग
Ritha	रीठा
Ritu	ऋतू
Rituraj	ऋतुराज
Riwa	रीवा
Riyadh	रियाध
Riyal	रियाल
Riz	रिज
Rizvi	रिजवी
Rizwan	रिज्वान
Ro	रो
Road	रोड
Robbery	रॉबरी
Rober	रॉबर
Roberta	रोबर्टा
Robertson	रॉर्बट्सन
Robin	रॉबिन
Robins	रॉबिन्स
Robinson	रॉबिनसन
Roch	रोच
Rochak	रोचक
Rochefort	रॉचेफोर्ट
Rochelle	रोशेल
Rockaway	रॉकवे
Rockwell	रॉकवेल
Rocky	रॉकी
Rod	रॉड
Rodd	रॉड
Roddy	रॉडी
Roden	रोडन
Roderick	रोडरिक
Roebuck	रोबक
Roentgenium	रॉएंटजीनियम
Rogers	रॉजर्स
Rohan	रोहण
Rohilla	रोहिल्ला
Rohinee	रोहिणी
Rohit	रोहित
Roj	रोज
Rokeby	रोकबाय
Roman	रोमन
Romania	रोमानिया
Romantic	रोमांटिक
Romesh	रोमेश
Romney	रोमनी
Romulo	रोमुलो
Ronalee	रोनेली
Ronat	रोनट
Ronda	रोंडा
Ronnie	रूनी
Ronstadt	रॉन्सडेट
Roohi	रूही
Roomal	रुमाल
Roony	रूनी
Roop	रूप
Roopakumaar	रूपकुमार
Roosevelt	रूजवेल्ट
Ros	रोस
Rosalie	रोसली
Rosamund	रोसमन्ड
Rosenberg	रोजनबर्ग
Roshan	रोशन
Roshanee	रोशनी
Rosie	रोजी
Ross	रॉस
Roster	रोस्टर
Rotterdam	रोटरडैम
Rotterdam	रोटर्डम
Rowe	रॉ
Roxanne	रोक्सन्ने
Roya	रोया
Royal	रॉयल
Royce	रॉयस
Roydon	रैडन
Roza	रोजा
Ruapehu	रुआपेहू
Rubicon	रुबिकन
Rubidium	रूबीडियम
Rubin	रुबिन
Ruchi	रुचि
Rudolf	रूडोल्फ
Rudra	रुद्र
Rue	रू
Rugby	रग्बी
Rujul	रुजुल
Rukanah	रुकनाह
Rumal	रुमाल
Rumba	रुंबा
Rumelihisar	रुमेलीहिसार
Rumesh	रुमेश
Rumsfeld	रम्सफ्रेल्ड
Runako	रुनाको
Rundle	रंडल
Rupak	रूपक
Rupana	रुपाणा
Rupashi	रूपशी
Rupashri	रूपश्री
Rupert	रूपर्ट
Rupesh	रूपेश
Rupiah	रुपिआह
Rupnagar	रुपनगर
Rupye	रुपए
Rushd	रुश्द
Russ	रस
Ruthenium	रूथेनियम
Rutherford	रुदरफोर्ड
Ruwan	रुवान
Ruzbehan	रुजबेहन
Ryann	रियान
Saad	साड
Saadat	सादत
Saadat	सादात
Saafale	साफले
Saagu	सागु
Saajan	साजन
Saakhare	साखरे
Saakshi	साक्षी
Saal	साल
Saamri	सामरी
Saamy	सामी
Saan	सान
Saane	साने
Saangha	सांघा
Saarangadhar	सारंगधर
Saarthak	सार्थक
Saat	सात
Saavarkar	सावरकर
Saawan	सावन
Saaya	साया
Sab	सब
Sabah	सबाह
Sabahat	सबाहत
Sabak	सबक
Sabar	सबर
Sabarwal	सबरवाल
Sabeeh	सबीह
Sabhy	सभ्य
Sabiha	साबिहा
Sabinal	सबीनल
Sabir	साबिर
Sabnis	सबनीस
Saboor	सबूर
Saboot	सबूत
Sabyasachi	सब्यसाची
Sacchidanand	सच्चिदानंद
Sach	सच
Sachchit	सच्चित
Sachetan	सचेतन
Sachin	सचिन
Sachkhand	सचखंड
Sachsen	सासेन
Sacramento	सैक्रामेंटो
Sacred	सेक्रेड
Sacred	सैक्रेड
Sadaf	सादाफ
Sadak	सडक
Saddam	सद्दाम
Sadeepan	सदीपन
Sadgati	सद्गति
Sadguna	सद्गुण
Sadhan	साधन
Sadhika	साधिका
Sadi	सदी
Sadma	सद्मा
Sadr	सद्र
Saed	सईद
Saeedah	सईदाह
Saeran	सैरेन
Safa	सफा
Safalataa	सफलता
Safar	सफर
Safwan	सफवान
Sagarika	सागरिका
Saggu	सग्गु
Sagheer	सगीर
Sagheerah	सगीराह
Sagina	सगीना
Sahariar	सहरियार
Saharsa	सहरसा
Saharwardy	सहरवर्दी
Sahas	सहस
Sahasrajit	सहस्रजित
Sahay	सहाय
Sahil	साहिल
Sahirah	सहिराह
Sahishnu	सहिष्णु
Sahitya	साहित्य
Sahl	सहल
Sahm	सहम
Sai	साई
Sai	साईं
Saibah	सैबाह
Saidah	सैदह
Sailaab	सैलाब
Sailani	सैलानी
Saim	सईम
Sainbi	सैंबी
Sainik	सैनिक
Saintgobain	सेंटगॉबैन
Saiprasad	साईप्रसाद
Sairah	साइराह
Sairaj	सैराज
Saiyan	सैया
Sajili	सजीली
Sajjanpur	सज्जनपुर
Sajni	सजनी
Sakhu	सखु
Sakshi	साक्षी
Salaam	सलाम
Saladin	सलादिन
Salamat	सलामत
Saleem	सलीम
Saleemah	सलीमाह
Salene	सेलेन
Salford	सेल्फोर्ड
Salgirah	सालगिरह
Salif	सलीफ
Salih	सलीह
Salihah	सलीहाह
Salikah	सलीकाह
Salila	सलिला
Salima	सलीमा
Salimbeni	सलीमबेनी
Salish	सालिश
Sall	सल्ल
Salle	सेल्ल
Salomi	सलोमी
Salsa	सालसा
Salt	साल्ट
Saluin	सालुइन
Salvador	साल्वाडोर
Salwa	सल्वा
Salwaan	सल्वान
Samad	समद
Samaja	समाज
Samar	समर
Samara	सामरा
Samarasekera	समारासेकरा
Samaraweera	समारावीरा
Samaraweera	सामरावीरा
Samarpan	समर्पण
Samarth	समर्थ
Samata	समता
Samavart	समवर्त
Samba	साम्बा
Sambad	संबद
Sambaran	समबरन
Sambhav	सम्भव
Samburwaryaar	सबुंरवरयार
Sameei	समीय
Sameera	समीरा
Samhita	समहिता
Samiksha	समीक्षा
Samit	समित
Samita	समिता
Samiur	समिउर
Samleshwar	सामलेश्वर
Sammelan	सम्मेलन
Samosir	सामोसिर
Sampat	सम्पत
Sampoorna	संपूर्ण
Sampreet	सम्प्रीत
Sampriti	सम्प्रीति
Samraat	सम्राट
Samran	सामरन
Samrendru	समरेंद्रू
Samsherbaz	समशेरबाझ
Samtel	सैम्टेल
Samudra	समुद्र
Samundari	समुंदरी
Samyak	सम्यक
San	सन
San	सान
San	सेन
San	सैन
Sanaa	साना
Sanam	सनम
Sananda	सानन्द
Sanat	सनत
Sanath	सनथ
Sanchali	संचाली
Sanchita	संचिता
Sandeep	संदीप
Sandesha	संदेशा
Sandhaya	संध्या
Sandhi	संधी
Sandia	सन्डिया
Sandipika	सन्दीपिका
Sandoval	सैंडोवल
Sanford	सैनफोर्ड
Sangakkara	संगाकारा
Sangam	संगम
Sangbad	संगबाद
Sangha	संघा
Sanghod	संघोड
Sanghursh	संघर्ष
Sanghvi	संघवी
Sangram	संग्राम
Saniyah	सानियाह
Sanjana	संजना
Sanjhi	सांझी
Sanjivan	संजीवन
Sanjukta	संजुक्ता
Sankalpa	संकल्पा
Sannidhi	सनिधि
Sanobar	सनोबर
Sanofi	सैनोफी
Sanor	सनोर
Sansaar	संसार
Sanskrit	संस्कृत
Santayani	संतायनी
Santiago	सेंटियागो
Santiago	सैन्टियेगो
Santo	सेंटो
Santo	सेन्टो
Santos	सेंटोज
Santos	सेंटोस
Santour	संतौर
Santushti	संतुष्टि
Sanvali	सांवली
Sanwari	सांवरी
Sanwaria	सावरिया
Sanyo	सैन्यो
Sanyogita	संयोगिता
Sanyukta	संयुक्ता
Saoirse	सेओइर्स
Saparna	सपर्णा
Sapiens	सैपियंस
Sapne	सपने
Sapnon	सपनोन
Saqlain	सक्लेन
Sarabhai	साराभाई
Saradindu	सरादिंदू
Sarah	सराह
Sarai	सराई
Sarakatsanoi	साराकत्सनोई
Sarakshi	सारक्षी
Saral	सरल
Sarama	सरमा
Saramago	सरभागो
Saramago	सरमागो
Saran	सरन
Sarangi	सारंगी
Saransh	सारांश
Saranya	सरण्या
Saras	सरस
Sarasota	सारासॉटा
Saratoga	सैराटोगा
Sardana	सरदाना
Sardar	सरदार
Sardesai	सरदेसाई
Sardinia	सार्दिनीया
Sareen	सरीन
Sargam	सरगम
Sargent	सार्जेंट
Sarguja	सरगुजा
Sarhaddi	सरहद्दी
Sarhindi	सरहिंदी
Sari	सरी
Sari	साडी
Sarika	सारिका
Sariska	सरिस्का
Sarita	सरिता
Saritaa	सरिता
Sarjana	सर्जना
Sarkari	सरकारी
Sarna	सरना
Sarnath	सारनाथ
Sarojani	सरोजनी
Sarra	सारा
Sarvesh	सर्वेश
Sasmita	सस्मिता
Sasta	सस्ता
Sasti	सस्ती
Sasun	ससुन
Sasural	ससुराल
Saswadkar	सासवडकर
Satang	सातांग
Satara	सतारा
Satchel	सेशेल
Satellite	सेटेलाइट
Sath	साथ
Sathanur	सथनूर
Sathi	साथी
Satija	सतीजा
Satna	सतना
Satsang	सतसंग
Sattar	सत्तार
Satvat	सत्वत
Satyajit	सत्यजित
Satyakam	सत्यकाम
Satyarupa	सत्यरूपा
Saubal	सौबल
Sauda	सौदा
Saudamini	सौदामिनी
Saudanttikar	सौंदत्तीकर
Saugaat	सौगात
Saughandh	सौगंध
Sauhaard	सौहार्द
Saul	सॉल
Saunders	सॉन्डर्स
Saurabh	सौरभ
Sautela	सौतेला
Savage	सैवेज
Savan	सावन
Savannah	सवान्ना
Savere	सवेरे
Savita	सविता
Savitaa	सविता
Savitashri	सावितश्री
Savitri	सावित्री
Savoie	सावोई
Savyasaachee	सव्यसाची
Sawan	सावन
Sawatch	सवाच
Sawdah	सौदाह
Sawini	साविनी
Sawsan	सौसन
Sawyer	सॉयर
Saxon	सॅक्सोन
Saxon	सैक्सऑन
Saxony	सेक्जॉनी
Sayf	सैफ
Sayid	सईद
Sayyar	सय्यार
Sayyidah	सईदाह
Saza	सजा
Scanian	स्कैनियन
Schell	स्क्हेल
Schiphol	स्किफोल
School	स्कूल
Schoolhouse	स्कूलहाउस
Schweitzer	श्वित्जर
Sciences	साइंस
Sciences	साइंसेस
Scientific	साइंटीफिक
Scooters	स्कूटर्स
Scorsese	स्कॉरसेस
Scot	स्कॉट
Sea	सि
Seaborgium	सीबोर्जियम
Seas	सीज
Sebastian	सेबस्टियन
Seccombe	सेकॉम्ब
Secondary	सेकंडरी
Secondary	सेकेंडरी
Secretary	सेक्रेटरी
Seda	सेडा
Seemaant	सीमांत
Seemant	सीमांत
Seeta	सीता
Seiko	सेइको
Sej	सेज
Sekhon	सेखोन
Sekhwa	सेखवा
Sekisui	सेकीसुई
Selaqui	सेलाकी
Selene	सेलेन
Selinaa	सेलिना
Selma	सेल्मा
Sema	सेमा
Semiconductor	सेमीकंडक्टर
Semple	सेम्पल
Senanayake	सेनानायक
Seoul	सियोल
Seoul	सेऊल
Sergio	सर्जियो
Sertao	सेरटाओ
Servicos	सर्विकोज
Sesa	सेसा
Sevaaram	सेवाराम
Sevaram	सेवाराम
Sevati	सेवती
Seven	सेवन
Seven	सेवेन
Seventies	सर्वेन्टीज
Sevier	सेवियर
Sewnarine	सेवनारायन
Seyyed	सय्यद
Shaadi	शादी
Shaaka	शाका
Shaaleen	शालीन
Shaan	शान
Shaarangikaa	शारंगिका
Shabb	शब
Shabbir	शब्बीर
Shabistan	शबिस्तान
Shadab	शदाब
Shadyanta	षडयंत्र
Shafaat	शफात
Shafee	शफी
Shafiah	शफियाह
Shafiek	शफीक
Shag	शैग
Shagufa	शगुफा
Shahaane	शहाणे
Shahar	शहर
Shahbaz	शाहबाज
Shaheed	शाहीद
Shaheedur	शहीदुर
Shaheenah	शाहीनाह
Shahenshan	शहंशाह
Shahi	शाही
Shahida	शाहिदा
Shahjahanpur	शाहजहापुर
Shahjehan	शहाजहा
Shahraj	शहराज
Shahrukh	शाहरुख
Shahzade	शहजादे
Shahzadi	शहजादी
Shaila	शैला
Shailesh	शैलेश
Shailey	शैलेय
Shair	शायर
Shaitani	शैतानी
Shajapur	शाजापुर
Shajarah	शाजराह
Shajeeah	शजीयाह
Shakambari	शाकम्बरी
Shake	शेक
Shakeel	शकील
Shakirah	शकीराह
Shaksha	शाकशा
Shakti	शक्ति
Shakti	शक्ती
Shakuhachi	शाकुहाची
Shalimar	शालीमार
Shalini	शालिनी
Shamashaad	शमशाद
Shambhavi	शाम्भवि
Shameem	शमीम
Shamel	शमेल
Shamil	शामिल
Shamshad	शमशाद
Shamsheer	शमशीर
Shamsher	शमशेर
Shamsuddin	शमसुद्दीन
Shamus	शमुस
Shan	शान
Shane	शेन
Shanghai	शंघाई
Shankaraachaary	शंकराचार्य
Shankaralaal	शंकरलाल
Shankari	शांकरी
Shanna	शाना
Shannon	शेन्नॉन
Shanpaak	शंपाक
Shanta	शांता
Shantala	शांतला
Shantanu	शांतनु
Shanthi	शांती
Shapath	शपथ
Shaqeeqah	श़कीकाह
Sharaabi	शराबी
Sharabi	शराबी
Sharad	शरद
Sharaf	शराफ
Sharangpani	शारंगपाणी
Sharanya	शरण्या
Shareekah	शरीकाह
Sharika	शारिका
Sharla	शर्ला
Sharlene	शर्लेन
Sharmistha	शर्मिष्ठा
Sharon	शेरॉन
Shart	शर्त
Sharvari	शर्वरि
Shashaankopal	शशांकोपल
Shashee	शशी
Shashi	शशि
Shastri	शास्त्री
Shasun	शैसुन
Shaswati	शास्वती
Shatadru	शतद्रु
Shatranj	शतरंज
Shatru	शत्रु
Shatrudaman	शत्रुदमन
Shatrughn	शत्रुघ्न
Shatrumardan	शत्रुमर्दन
Shaukeen	शौकीन
Shaunna	शॉना
Shaw	शॉ
Shawn	शॉन
Shawna	शॉना
Shay	शे
Shayla	शैला
Shayma	शायमा
Sheadon	शीडन
Sheahan	शीहन
Shebeli	शबेली
Sheen	शीन
Sheeshmahal	शीशमहल
Sheetalaa	शीतला
Sheffield	शेफिल्ड
Sheffield	शेफफील्ड
Shehri	शेहरी
Sheila	शैला
Shejali	शेजाली
Shekhar	शेखर
Shekhpura	शेखपुरा
Shel	शेल
Shendurnikar	शेंदुर्णीकर
Shepherd	शेप्हर्ड
Shera	शेरा
Sherburne	शरबर्न
Sherdil	शेरदिल
Sherkar	शेरकर
Sherlock	शर्लाक
Sherni	शेरनी
Sheroo	शेरू
Sherwood	शेरवुड
Sheshashaayee	शेषशायी
Shevanti	शेवंती
Shevgaonkar	शेवगावकर
Shibani	शिबानी
Shifa	शिफा
Shifaa	शिफा
Shikayat	शिकायत
Shikhaa	शिखा
Shikhar	शिखर
Shikishima	शिकीशिमा
Shiksha	शिक्षा
Shilling	शिलिंग
Shilpa	शिल्पा
Shilpita	शिल्पिता
Shimla	शिमला
Shinaki	शिनाकी
Shinano	शिनानो
Shindi	शिंदी
Shing	शिंग
Shintre	शिंत्रे
Shirazi	शिराजी
Shirazi	शिरजी
Shirdi	शिर्डी
Shire	शाएर
Shirin	शिरीन
Shirina	शिरिना
Shishapaa	शिशपा
Shiti	शिति
Shiva	शिव
Shiva	शिवा
Shivakumaar	शिवकुमार
Shivanandan	शिवनंदन
Shivangi	शिवांगी
Shivapriyaa	शिवप्रिया
Shivlal	शिवलाल
Shivnekar	शिवणेकर
Shivpuri	शिवपुरी
Shivsagar	शिवसागर
Shnewala	स्नेवला
Shoaib	शोएब
Shobha	शोभा
Shobhaa	शोभा
Shobhana	शोभना
Shodh	शोध
Shoes	शूज़
Shohrat	शोहरत
Shokhiyan	शोखियाँ
Shola	शोला
Sholay	शोले
Sholayar	शोलायर
Shome	शोम
Shor	शोर
Shotley	शोटे
Shoushan	शॉशन
Show	शो
Shravasti	श्रावस्ती
Shree	श्री
Shreela	श्रीला
Shrey	श्रेय
Shreyas	श्रेयस
Shridhar	श्रीधर
Shrigopal	श्रीगोपाल
Shrihari	श्रीहरि
Shrijani	श्रीजनी
Shrikirti	श्रीकीर्ति
Shrikrishna	श्रीकृष्ण
Shrikrushna	श्रीकृष्ण
Shrikumari	श्रीकुमारी
Shrilata	श्रीलता
Shrimayi	श्रीमयी
Shripad	श्रीपाद
Shriprakash	श्रीप्रकाश
Shriram	श्रीराम
Shrivalli	श्रीवल्लि
Shubh	शुभ
Shubhangi	शुभांगी
Shubhra	शुभ्रा
Shubhraanshu	शुभ्रांशु
Shuchita	शुचिता
Shuk	शुक
Shukti	शुक्ती
Shumaylah	शुमेलाह
Shumaysah	शुमेसाह
Shunbhanaashinee	शुंभनाशिनी
Shurayh	शुरायह
Shvetaanbar	श्वेतांबर
Shwadhinota	श्वाधिनोता
Shweta	श्वेता
Shyaamaa	श्यामा
Shyaamakanth	श्यामकंठ
Shyam	श्याम
Shyamala	श्यामला
Shyamalika	श्यामलिका
Shyamalima	श्यामलिमा
Shyamlata	श्यामलता
Sian	सिआन
Siau	सिओ
Sibani	सिबानी
Sibelius	सिबेलियुस
Siberut	सिबेरुट
Sibley	सिब्ली
Sicilia	सिसिलिया
Sicily	सिसीली
Siddarthnagar	सिद्धार्थनगर
Siddhamalli	सिद्धामली
Siddhatek	सिद्धटेक
Siddheshwari	सिद्धेश्वरी
Siddhima	सिद्धिमा
Siddhu	सिद्धु
Siddiqui	सिद्दिकी
Siddons	सिड्डोंस
Side	साईड
Sidebottom	साइडबॉटम
Sidewise	साइडवाइज
Sidhdheshvar	सिद्धेश्वर
Sidhdhi	सिद्धि
Sidhhgosht	सिद्धघोष्ट
Sidhi	सीधी
Sidhu	सिद्धू
Sidney	सिडनी
Sidonia	सिडोनिया
Sidrah	सिद्राह
Sierra	सिइरा
Sierra	सिएरा
Sierra	सिर्रा
Sihlsee	सिहल्सी
Siju	सिजु
Sikand	सिकंद
Sikandar	सिकंदर
Sikandar	सिकन्दर
Sikatuna	सिकातुना
Sikkim	सिक्किम
Sikri	सिकरी
Sila	सिला
Silicom	सिलिकॉम
Siliconware	सिलिकॉनवेयर
Silk	सिल्क
Silvain	सिल्वैन
Silverline	सिल्वरलाइन
Sima	सिमा
Simak	सिमक
Simon	सिमॉन
Simone	सिमोन
Simons	सिमोन्स
Simpson	सिंपसोन
Simpson	सिम्पसन
Sinan	सिनान
Sinclair	सिंक्लेयर
Sinclair	सिनक्लेयर
Sinead	सिनीड
Singaar	सिंगार
Singapore	सिंगापुर
Singar	सिंगार
Singer	सिंगर
Singh	सिंघ
Singh	सिंह
Singha	सिंघा
Singhania	सिंघानिया
Singhasan	सिंहासन
Singla	सिंगला
Sinha	सिन्हा
Sinharaja	सिंहराजा
Sinhasan	सिंहासन
Sinhgad	सिंहगड
Sinochem	सिनोकेम
Sintex	सिन्टेक्स
Sir	सर
Siraj	सिराज
Sirazuddaula	सिराजुद्दौला
Sirf	सिर्फ
Sirmaur	सिरमौर
Sirmilik	सिर्मिलिक
Sirvat	सरवैट
Sissy	सिसी
Sister	सिस्टर
Sita	सीता
Sitaanshuk	सितांशुक
Sitakant	सीताकांत
Sitamgar	सितमगर
Sitar	सितार
Sitara	सितारा
Sitare	सितारे
Sitaron	सितारो
Sitka	सित्का
Sivaramakrishnan	सिवरामकृष्णन
Siwan	सीवान
Siwar	सिवार
Six	सिक्स
Siyang	सियांग
Skating	स्केटिंग
Skiing	स्कीइंग
Skipper	स्किपर
Skirrow	स्किरॉ
Skirth	स्कर्थ
Slack	स्लैक
Slalom	स्लेलम
Sledge	स्लेज
Slocum	स्लोकम
Slough	स्लॉ
Smaram	स्मरम
Smart	स्मार्ट
Smarties	स्मार्टीज
Smile	स्माइल
Smoker	स्मोकर
Smruti	स्मृति
Snaith	स्नैथ
Snape	स्नैप
Snedden	स्नेडन
Sneha	स्नेहा
Snehalata	स्नेहलता
Snehlata	स्नेहलता
Snehlataa	स्नेहलता
Snelling	स्नेलिंग
Snigdha	स्निग्धा
Snow	स्नो
Snowdonia	स्नोडोनिया
Sobers	सोबर्स
Soch	सोच
Socialist	सोशलिस्ट
Sofia	सोफिया
Sofian	सोफियां
Sofoklis	सोफोक्लीज
Sohail	सोहेल
Sohail	सोहैल
Sohani	सोहनी
Sohi	सोही
Soin	सोइन
Sokhi	सोखी
Solah	सोलह
Solana	सोलेना
Solanki	सोलंकी
Solectron	सोलेक्ट्रॉन
Soleil	सोलैल
Solferino	सोल्फेरिनो
Solkar	सोल्कर
Solomos	सोलोमस
Solomos	सोलोमॉस
Solstice	सोलस्टिस
Solutions	सॉल्युशंस
Solutions	सॉल्यूशंस
Solutions	सॉल्यूशन
Solutions	सॉल्यूशन्स
Som	सोम
Somaanshu	सोमांशु
Somadev	सोमदेव
Somakaantaa	सोमकांता
Somakant	सोमकांत
Somakanta	सोमकांता
Soman	सोमण
Somansh	सोमांश
Somendra	सोमेंद्र
Somkaantaa	सोमकांता
Somlataa	सोमलता
Sona	सोना
Sonachanpaa	सोनचंपा
Sonali	सोनाली
Sonar	सोनार
Sonata	सोनाटा
Sond	सौंद
Sonika	सोनिका
Sonitpur	सोनीतपुर
Soniyaa	सोनिया
Sonnagh	सोनाग
Sonpur	सोनपुर
Sony	सोनी
Sonya	सोनिया
Sood	सूद
Soona	सूना
Soory	सूर्य
Sooryakaantaa	सूर्यकांता
Sooryamukhee	सूर्यमुखी
Sooryaputree	सूर्यपुत्री
Sophia	सोफिया
Sophie	सोफी
Sorath	सोरथ
Soryu	सोर्यू
Sothern	साउदर्न
Soukhi	सौखी
Sound	साउंड
South	साउथ
South	साऊथ
Southampton	साउथएंपटन
Southampton	साउथम्पटन
Southern	साउथर्न
Southhall	साउथहाल
Southwick	साउथविक
Soutzos	सौत्जोस
Sowani	सोवानी
Spa	स्पा
Spain	स्पेन
Sparviero	स्पारविएरो
Spearman	स्पियरमैन
Spence	स्पेंस
Spencer	स्पेंसर
Spencer	स्पेन्सर
Spin	स्पिन
Spingarn	स्पिनगार्न
Spinnin	स्पिनिन
Spirit	स्पिरिट
Spiro	स्पिरो
Spitbank	स्पिटबैंक
Spitsbergen	स्पीट्सबर्गन
Spock	स्पॉक
Spring	स्प्रिंग
Springsteen	स्प्रिंगस्टीन
Spyridon	स्पाइरिडोन
Sridharan	श्रीधरन
Srikkanth	श्रीकांत
Srinath	श्रीनाथ
Srinivasan	श्रीनिवासन
Srirangam	श्रीरंगम
Srivilliputtur	श्रीविलीपुट्टुर
Ssangyong	सैंगयोंग
Stacie	स्टेसी
Stalin	स्टॅलिन
Stalin	स्टेलिन
Stanislaw	स्टैनिस्लाव
Stansted	स्टैनस्टेड
Stapleton	स्टेपलेटन
Starr	स्टार
Stars	स्टार्स
Stash	स्टैश
Station	स्टेशन
Stavita	स्तविता
Stead	स्टीड
Stee	स्टी
Steeg	स्टीग
Steel	स्टील
Stefanie	स्टेफेनी
Stele	स्टेल
Stemnitsa	स्टेमनिट्सा
Stennis	स्टेनिस
Step	स्टेप
Stephan	स्टीफन
Stephen	स्टीफन
Sterling	स्टर्लिंग
Steve	स्टीव
Stevenson	स्टीवंसन
Stew	स्टीव
Steyn	स्टेयन
Stillman	स्टिलमैन
Stirling	स्टरलिंग
Stockholm	स्टॉकहोम
Stones	स्टोन्स
Stora	स्टोरा
Storm	स्टॉर्म
Stotinki	स्टोटिन्की
Stott	स्टोट
Strait	स्ट्रेट
Strasser	स्ट्रेसर
Strauss	स्ट्रोस
Streak	स्ट्रीक
Stride	स्ट्राइड
Strom	स्टोर्म
Strontium	स्ट्रोन्शियम
Stu	स्टू
Stuarts	स्टुअर्ट
Studio	स्टुडियो
Stupa	स्तूपा
Stuttgart	स्टटगर्ट
Subayah	सुबेयाह
Subbooh	सुब्बूह
Subex	सुबेक्स
Subhaash	सुभाष
Subhadra	सुभद्रा
Subhedar	सुबेदार
Sucharita	सुचरिता
Sucheta	सुचेता
Suchi	सुची
Sudaama	सुदामा
Sudama	सुदामा
Sudarshana	सुदर्शना
Sudath	सुदाथ
Sudeepta	सुदीप्ता
Sudha	सुधा
Sudhaa	सुधा
Sudhaakar	सुधाकर
Sudhamayi	सुधामयी
Sudhanshu	सुधांशु
Sudhira	सुधिरा
Sudi	सुदी
Suez	स्युएज
Suez	सूएज
Suez	स्वेज
Sughra	सुघरा
Sugouri	सुगौरी
Suhane	सुहाने
Suhayl	सुहेल
Suheera	सुहीरा
Sujala	सुजला
Sukaynah	सुकेनाह
Sukh	सुख
Sukhdev	सुखदेव
Sukhha	सुख्हा
Sukhinder	सुखिन्दर
Sukumari	सुकुमारी
Sulabha	सुलभा
Sulaiman	सुलैमान
Sulakshana	सुलक्षणा
Sulalita	सुललिता
Sulawesi	सुलावेसी
Sulayk	सुलेक
Sullivan	सुलीवान
Sullivan	सूलीवेन
Suloch	सुलोच
Sulochanadevi	सुलोचनादेवी
Sultani	सुल्तानी
Sultanpur	सुल्तानपुर
Sulzberger	सल्जबरगर
Sumana	सुमन
Sumanolata	सुमनोलता
Sumitomo	सुमितोमो
Sumitra	सुमित्रा
Sumitranandan	सुमित्रानंदन
Summerside	समरसाइड
Sunaharaa	सुनहरा
Sunanda	सुनन्दा
Sunayana	सुनयना
Sunayani	सुनयनी
Sundar	सुन्दर
Sundareshvara	सुंदरेश्वर
Suneet	सुनीत
Sunflag	सनफ्लैग
Suniti	सुनीति
Sunje	संज
Suno	सुनो
Sunopta	सनऑप्टा
Sunset	सनसेट
Supa	सुपा
Suparna	सुपर्णा
Suprabha	सुप्रभा
Supreme	सुप्रीम
Supriy	सुप्रिय
Sur	सुर
Surabhi	सुरभि
Suraj	सुरज
Suranjana	सुरंजना
Surasakhaa	सुरसखा
Surayj	सुरैज
Surdas	सूरदास
Surekha	सुरेखा
Surfing	सर्फिंग
Surinder	सुरिंदर
Surkhiyaan	सुर्खिया
Surrey	सरेय
Suru	सुरु
Suruchi	सुरुचि
Suruj	सुरज
Suryakanti	सूर्यकांति
Sushamaa	सुषमा
Susheel	सुशील
Susheelaa	सुशीला
Susheet	सुशीत
Sushila	सुशीला
Susie	सूसी
Susita	सुसिता
Sussex	सुसेक्स
Sutaa	सुता
Sutantar	सुतंतर
Sutanuka	सुतनुका
Suvaas	सुवास
Suvarnmala	सुवर्णमाला
Suvorov	सुवोरोव
Suwaydah	सुवेदाह
Svaraaj	स्वराज
Svarnbhooshan	स्वर्णभूषण
Svarnpushpee	स्वर्णपुष्पी
Svaroopabaaee	स्वरूपबाई
Svirka	स्विरका
Swadesh	स्वदेश
Swaggart	स्वागर्ट
Swaha	स्वाहा
Swain	स्वैन
Swami	स्वामी
Swaminath	स्वामीनाथ
Swamy	स्वामी
Swanson	स्वैनसन
Swapn	स्वप्न
Swapna	स्वप्ना
Swapneel	स्वप्निल
Swaraj	स्वराज
Swaroop	स्वरूप
Swarthi	स्वार्थी
Swasti	स्वस्ति
Swastik	स्वास्तिक
Swatantra	स्वतंत्र
Swati	स्वाति
Swayamvar	स्वयंवर
Sweden	स्वीडन
Sweekar	स्वीकार
Swiftsure	स्विफ्टश्योर
Swiss	स्विस
Sword	स्वॉर्ड
Sybil	सिबिल
Sydney	सिडनी
Sylvana	सिल्वेना
Sylvia	सिल्विया
Sylvie	सिल्वी
Symcox	सिम्कॉक्स
Symona	सिमोना
Symonds	सायमंड्स
System	सिस्टम
System	सिस्टम्स
Systems	सिस्टम्स
Szent	स्जेंट
Taan	तान
Taank	टांक
Taaqat	ताकत
Taaraapati	तारापति
Taashkand	ताशकंद
Tabalah	तबलाह
Tabassum	तबस्सुम
Taber	ताबेर
Tabla	तबला
Tacita	टेसिता
Tacy	टेसी
Tad	टेड
Tadiaal	टडिआल
Taekwondo	टायक्वोंडो
Tagore	टागोर
Tahina	टहिणा
Tahir	ताहिर
Tahoor	तहूर
Tahseen	तहसीन
Taiban	ताइबान
Taibu	टैबू
Tait	टैट
Tajammul	ताजम्मुल
Tajuddin	तजुद्दीन
Tajurba	तजुर्बा
Tak	तक
Takeda	टकेडा
Takle	टकले
Takrana	टकराना
Tal	तल
Tala	ताला
Talat	तलत
Talewal	तलेवाल
Talha	ताल्हा
Talhah	तलहाह
Tali	ताली
Talladega	टेलाडेगा
Tallinn	तल्लिन
Tallis	टेलिस
Talon	टेलॉन
Talukdar	तालुकदार
Talwada	तलवाडा
Tam	टेम
Tamalika	तमालिका
Tamanna	तमन्ना
Tamas	टामस
Tamasha	तमाशा
Tambala	तंबाला
Tambora	तम्बोरा
Tamborim	तम्बोरिम
Tambura	तम्बूरा
Tameemah	तमीमाह
Tamesis	टेमेसिस
Tamhankar	ताम्हनकर
Tamilnadu	तमिलनाडू
Tamkeen	तमकीन
Tampa	टाम्पा
Tan	तन
Tanbur	तान्बूर
Tandem	टैंडम
Taner	तनीर
Tanganyika	टांगानाइका
Tangia	टेंजिया
Tango	टैंगो
Tanizaki	तानीजकी
Tanmaya	तन्मया
Tanners	टैनर्स
Tanseem	तंजीम
Tantalum	टैंटलम
Tanu	तनु
Tanuka	तनुका
Tanwir	तनवीर
Tapas	तपस
Tapati	तपति
Tara	टैरा
Tara	तारा
Tarak	तारक
Tarakini	ताराकिनी
Taraknath	तारकनाथ
Taramati	तारामती
Tarangini	तारांगिणी
Tarangire	तरांजिरे
Tarashankar	ताराशंकर
Taravindar	तरविंदर
Tarazu	तराजू
Tareq	तारीक
Tariqah	तारि़काह
Tarjani	तर्जनी
Tarogato	टैरोगेटो
Taru	तरु
Tarub	तरुब
Tarulata	तरुलता
Tarun	तरुण
Tarunaa	तरुणा
Taseen	तसीन
Tasmania	तस्मानिया
Tasneen	तस्नीन
Tassos	टैसस
Tatra	टाट्रा
Taufeeq	तौफीक
Tavleen	तवलीन
Tawaif	तवायफ
Tawakkal	तवाकल
Tawang	तवांग
Tawqeer	तौकीर
Tawwab	तव्वाब
Tayade	तायडे
Taybah	तयबाह
Taylor	टेलर
Taza	ताजा
Teague	टीग
Teams	टीम्स
Technetium	टेक्नीशियम
Technologies	टेक्नोलॉजिस
Technologies	टेक्नोलॉजीस
Technology	टेक्नोलॉजी
Teen	तीन
Teerth	तीर्थ
Teesra	तीसरा
Tehelka	तहलका
Tehran	तेहरान
Tehri	टिहरी
Teigra	टैग्रा
Tej	तेज
Tejaswi	तेजस्वी
Tejaswini	तेजस्विनी
Teji	तेजी
Tejon	टेजॉन
Tekli	टेक्ली
Tekri	टेकरी
Tel	तेल
Telang	तेलंग
Telecommunication	टेलीकम्यूनीकेशन
Teledata	टेलीडेटा
Telenor	टेलीनॉर
Telephone	टेलीफोन
Television	टेलीविजन
Tellurium	टेल्यूरियम
Telma	टेल्मा
Telocation	टेलोकेशन
Telstra	टेलस्ट्रा
Telugu	तेलुगू
Telyn	टेलिन
Temeraire	टेमेरेयर
Tempest	टेम्पेस्ट
Templeton	टेम्प्लेटन
Teng	टेंग
Tengger	टेनग्गर
Tennekoon	टेनेकून
Tennessee	टेनेसी
Tera	तेरह
Tera	तेरा
Teranika	टेरेनिका
Terbium	टर्बियम
Terbrugge	टर्ब्रग
Tere	तेरे
Teri	तेरी
Terminus	टर्मिनस
Terra	टेरा
Terribile	टेरिबील
Territory	टेरिटरी
Terry	टेरी
Terry	टैरी
Tertius	टरटियुस
Teryl	टेरिल
Tesco	टेस्को
Tewaaraton	टेवारटन
Texas	टेक्सास
Textiles	टेक्सटाइल्स
Tezaab	तेजाब
Tha	था
Thadeus	थाडेअस
Thakkar	ठक्कर
Thakral	ठकराल
Thalabah	थलाबाह
Thalia	थालीया
Thambalahalli	थम्बलाहाली
Thaminah	थमिनाह
Thane	ठाणे
Thanos	थनोस
Tharya	थार्या
Thauban	थौबान
Thavil	थैविल
Thawab	थवाब
Thendayuthapani	थेंदयूथपानी
Theodora	थियोडोरा
Theodore	थियोडोर
Theodore	थीओडोर
Theophilia	थियोफिलिया
Theophilus	थियोफिलस
Theresa	टेरेसा
Theresa	थेरेसा
Thermax	थर्मेक्स
Thermopylae	थर्मोपाइली
Thikria	ठिकरिया
Thipse	टिप्से
Thirty	थर्टी
Thirukkulunkunram	तिरुक्कुलुन्कुंरम
Thirumalai	तिरुमलाई
Thirumurthi	थिरुमूर्थी
Thirunarayan	तिरुनारायण
Thirunavukkarasu	थिरुनावुक्करासु
Thiruvanaikaval	तिरुवन्नाइकवल
Thom	थॉम
Thomas	थॉमस
Thomas	थोमस
Thorington	थोरिंग्टन
Thorium	थोरियम
Thorolf	थोरोल्फ
Thorpe	थोर्प
Thracian	थ्रासियन
Three	थ्री
Thulium	थूलीयम
Thumamah	थुमामाह
Thuml	थुमल
Thuringen	थरिंगन
Tiara	टियारा
Tickner	टिक्नर
Tienhoven	तीनहॉवेन
Tiernan	तिएर्नन
Tiffany	टिफेनी
Tihami	तिहामी
Tila	टीला
Tilaka	तिलका
Tilbury	टिल्बरी
Timbe	टिंबे
Timedouine	टाइमडोयून
Timila	तिमिला
Timin	तिमिन
Timor	तिमोर
Timothy	टिमोथी
Timothy	तिमोथी
Tin	टिन
Tinu	टीनू
Tirap	तिरप
Tirucherai	तिरुचेरई
Tirukkannankudi	तिरुक्कन्नानकुडी
Tirukkottiyur	तिरुक्कोत्तियूर
Tirupparamkunram	तिरुप्पराम्कुंरम
Tiruvallikeni	तिरुवल्लीक्केनी
Tiruvannamalai	तिरुवन्नामलाई
Tiruvattar	तिरुवत्तर
Tisha	तिशा
Tista	तिस्ता
Titan	टाइटन
Titania	टिटानिया
Titmus	टिटमस
Tiwana	तिवाना
To	टू
Tod	टॉड
Todd	टॉड
Toere	टोएरे
Tohda	टोहडा
Tohoku	तोहोकु
Toktogul	टोक्टोगुल
Tolchard	टोल्चार्ड
Tolstoy	टॉलस्टाय
Tomas	टॉमस
Tonganoxie	टाँगनॉक्सी
Tonk	टोंक
Tonya	टोन्या
Toofan	तूफान
Toohey	टूहे
Toor	तूर
Toote	टूटे
Top	टॉप
Torie	टोरी
Tosa	टोसा
Tosca	टोस्का
Totten	टॉटन
Toulouse	टॉउलोउस
Tour	टूर
Tourville	टूरविले
Towers	टॉवर्स
Town	टाउन
Townsend	टाउनसेंड
Toyesh	तोयेश
Toyota	टोयोटा
Traicos	ट्रैकोस
Transfi	ट्रांसफी
Transport	ट्रांसपोर्ट
Travis	ट्रॅविस
Travis	ट्रेविस
Tregrosse	ट्रेग्रोसी
Tremlett	ट्रेमलेट
Trend	ट्रेंड
Trenton	ट्रेंटोन
Treva	ट्रेवा
Trevor	ट्रेवर
Tribhwan	त्रिभवन
Trikon	त्रिकोण
Trinayani	त्रिनयनी
Trinculo	ट्रिनक्यूलो
Trinetra	त्रिनेत्रा
Trini	ट्रीनी
Tripurari	त्रिपुरारी
Tripuri	त्रिपुरी
Trisha	तृशा
Trista	त्रिस्ता
Tristram	ट्रिस्ट्रम
Triumph	ट्रायंफ
Triveni	त्रिवेणी
Trolle	ट्रोली
Tromp	ट्रॉम्प
Trophy	ट्रॉफी
Troposphere	ट्रोपोस्फीयर
Troughton	ट्रॉग्टन
Troup	ट्रूप
Truly	ट्रूली
Trumbull	ट्रम्बुल
Trump	ट्रंप
Trump	ट्रम्प
Trupti	तृप्ति
Trust	ट्रस्ट
Trustees	ट्रस्टीस
Tryna	ट्राना
Tryphena	ट्रायफेना
Tsitsikamma	त्सीत्सीकामा
Tu	तू
Tuckaleechee	टूकालीची
Tudd	तुड़
Tudor	ट्यूडर
Tufnell	टफनेल
Tugal	तुगल
Tuhina	तुहिना
Tul	तुल
Tully	टुली
Tumadur	तुमादुर
Tung	तुंग
Tungabhadra	तुंगभद्रा
Tupal	तुपल
Tura	तूरा
Turkana	तुर्काना
Turkey	तुर्की
Turkish	तुर्किश
Turko	तुर्को
Turrets	टरेट्स
Tuscarora	टस्करोरा
Tushar	तुषार
Tuteja	टुटेजा
Twarit	त्वरित
Twila	ट्विला
Tyanne	टायनी
Tyger	टिगर
Tyrone	टायरॉन
Tzouras	त्जौरस
Tzu	त्झू
Ubaydullah	उबैदुल्लाह
Uchh	उच
Ud	उद
Udayan	उदयन
Udayshankar	उदयशंकर
Uddhav	उद्धव
Udu	उदु
Ugine	युजीन
Uillean	युल्लीन
Uitermeer	उइतरमीर
Ujas	उजास
Ujung	उजुंग
Ul	उल
Ula	यूला
Ulmer	उल्मेर
Ulta	उल्टा
Ulupi	उलुपी
Ulysses	उलीसेस
Ulysses	यूलिसेस
Uma	उमा
Umanath	उमनाथ
Umarah	उमराह
Umashankar	उमाशंकर
Umaymah	उमैमाह
Umayr	उमायर
Umika	उमिका
Ummayyah	उम्मय्याह
Una	यूना
Unaysah	उनैसाह
Underwood	अंडरवुड
Unichem	युनिकेम
Unichem	यूनीकेम
Unicoi	यूनीकोई
Union	युनियन
Unitis	यूनिटिस
University	युनिवर्सिटी
University	यूनिवर्सिटी
Unsworth	अनसोर्थ
Ununbium	यूननबियम
Ununhexium	यूननहैक्सियम
Ununquadium	यूननक्वेडियम
Ununtrium	यूननट्रियम
Upadhye	उपाध्ये
Upamanyu	उपमन्यु
Upashantha	उपाशंथा
Upmanyu	उपमन्यु
Uppar	उप्पर
Upul	उपुल
Uqbah	उक्बाह
Urania	यूरेनिया
Uranus	यूरेनस
Urdu	उर्दू
Uri	उरी
Urian	यूरियन
Urshita	उर्शिता
Uruguay	उरुगैय
Urwah	उर्वाह
Usayd	उसैद
Ustad	उस्ताद
Ustadi	उस्तादी
Utaybah	उतैबाह
Utha	उठा
Uthappa	उथप्पा
Utpal	उत्पल
Utsaah	उत्साह
Uttam	उत्तम
Uttom	उत्तोम
Uwharrie	उव्हारी
Uzayr	उजैर
Vaachaa	वाचा
Vaachikaa	वाचिका
Vaadkar	वाडकर
Vaageesh	वागीश
Vaageeshvaree	वागीश्वरी
Vaageshvaree	वागेश्वरी
Vaagmitaa	वाग्मिता
Vaal	वाल
Vaalbos	वालबॉस
Vaaman	वामन
Vaapikaa	वापिका
Vaaruni	वारुणि
Vaas	वास
Vaasantee	वासंती
Vaasavee	वासवी
Vaataalee	वाताली
Vaataketu	वातकेतु
Vachan	वचन
Vadher	वाढेर
Vadodara	वडोदरा
Vafi	वाफी
Vafia	वाफिया
Vaheeda	वहीदा
Vahida	वाहिदा
Vaibhavee	वैभवी
Vaidehi	वैदेही
Vaidya	वैद्य
Vaijayanti	वैजयंती
Vaikharee	वैखरी
Vaikom	वैकॉम
Vairaagee	वैरागी
Vairaaj	वैराज
Vaishalini	वैशालिनी
Vaishnav	वैष्णव
Vajeer	वजीर
Vajraabh	वज्राभ
Vajraachaary	वज्राचार्य
Vala	वेला
Valentino	वैलेंटिनो
Valeria	वेलेरिया
Valerian	वेलेरियन
Valero	वैलेरो
Valeureuse	वैलेरेयूज
Valiant	वेलीयंट
Valley	वैली
Valmai	वल्माई
Valmor	वेल्मोर
Valora	वेलोरा
Valour	वैलर
Valsad	वलसाड
Valuable	वैल्युएबल
Vanamaalee	वनमाली
Vanamala	वनमाला
Vanavil	वनविल
Vanburn	वैनबर्न
Vance	वेन्स
Vance	वैंस
Vancouver	वैनकॉवर
Vancouver	वैनक्यूवर
Vandan	वन्दन
Vanee	वाणी
Vanessa	वेनसा
Vangie	वेनजी
Vanhi	वान्ही
Vanita	वनिता
Vanoise	वैनॉइस
Vantaa	वान्टा
Varaj	वराज
Varan	वरण
Varattupallam	वरत्तुपल्लम
Varda	वर्दा
Vardi	वर्दी
Varee	वल्लरी
Varij	वारिज
Varsha	वर्षा
Vartan	वार्टन
Vartouhi	वर्टोही
Varun	वरुण
Vasantika	वसंतिका
Vasavi	वासवी
Vasbert	वैसबर्ट
Vashishth	वशिष्ठ
Vasu	वासु
Vasudev	वासुदेव
Vasudevyaa	वसुदेव्या
Vatika	वाटिका
Vats	वत्स
Vatsal	वत्सल
Vaughan	वॉगन
Veadeiros	विएडिरोस
Ved	वेद
Vedavatee	वेदवती
Vedavyaas	वेदव्यास
Vedee	वेदी
Vedi	वेदी
Vedic	वैदिक
Vedikaa	वेदिका
Veena	वीणा
Veer	वीर
Veerandhar	वीरंधर
Veerendra	वीरेंद्र
Veerkar	वीरकर
Veeru	वीरू
Vega	वेगा
Vegas	वेगास
Vegavaahee	वेगवाही
Vela	वेला
Velaa	वेला
Veladero	वेलाडेरो
Vellore	वेल्लोर
Velvet	वेल्वेट
Vendee	वेंडी
Veneriology	वेनरियोलॉजी
Venetia	वेनिशिया
Veneto	वेनटो
Venezuela	वेनजुएला
Vengsarkar	वेंगसरकर
Venkateshwar	वेंकटेश्वर
Ventre	वेंटर
Venu	वेणु
Venugopal	वेणुगोपाल
Venus	वीनस
Veolia	वेओलिया
Veradis	वेरेडिस
Verdi	वर्दी
Veria	वेरिया
Vermeulen	वर्म्यूलेन
Vernados	वर्नाडोस
Vernalis	वेर्नलीस
Verne	वर्ने
Veronique	वेरोनिक
Verrazano	वेराजनो
Vesta	वेस्टा
Veste	वेस्ट
Vetaal	वेताल
Vetravati	वेत्रवती
Vettori	वेटोरी
Vevina	वेविना
Vi	वी
Viapeeth	वियापीठ
Viareggio	वायरेगियो
Vibhas	विभास
Vibhishan	विभीषण
Vibhooshan	विभूषण
Vibhooshit	विभूषित
Vibhooti	विभूति
Vibhutaa	विभुता
Vicky	विक्की
Vico	विको
Victor	विक्टर
Victory	विक्ट्री
Vida	विडा
Video	वीडियो
Vidhaata	विधाता
Vidooramani	विदूरमणि
Vidor	विडोर
Vidrohi	विद्रोही
Vidwans	विद्वांस
Vidyul	विद्युल
Vidyut	विद्युत
Vidyuta	विद्युता
Viennese	विएनीज
Vieux	व्युक्स
Vihuela	विहुएला
Vijayadurg	विजयदुर्ग
Vijayalakshmee	विजयलक्ष्मी
Vijayanagar	विजयनगर
Vijender	विजेंदर
Vijetaa	विजेता
Vijeti	विजेती
Vijitendriy	विजितेंद्रिय
Viklav	विक्लव
Vikramjit	विक्रमजीत
Vilas	विलास
Village	विलेज
Villette	विलेट
Vilmaris	विल्मेरिस
Vilmos	विल्मोस
Vilnius	बिल्नियस
Vimicro	विमीक्रो
Vimogh	विमोघ
Vimohinee	विमोहिनी
Vimta	विम्ता
Vin	विन
Vinamr	विनम्र
Vinatee	विनती
Vinati	विनती
Vinaya	विनया
Vinayekaar	विनायकार
Vinny	विन्नी
Vinoba	विनोबा
Vinson	विंसन
Vinson	विनसन
Vinya	विनया
Viola	वीओला
Viplaav	विप्लाव
Viplavee	विप्लवी
Vipul	विपुल
Vir	वीर
Viraag	विराग
Viraat	विराट
Viraj	विराज
Virat	विरत
Virginia	वर्जीनिया
Virtual	वर्च्युअल
Virtuti	वीरटुटी
Virupaksha	वीरूपक्ष
Vishakha	विशाखा
Vishal	विशाल
Vishala	विशाला
Vishalakshi	विशालाक्षी
Vishalgad	विशालगड
Visham	विषम
Vishavanbhar	विशवंभर
Vishaya	विषया
Vishnupriya	विष्णुप्रिया
Vishram	विश्राम
Vishvaamitr	विश्वामित्र
Vishvaas	विश्वास
Vishvaatmaa	विश्वात्मा
Vishvag	विश्वग
Vishvakarmaa	विश्वकर्मा
Vishveshvar	विश्वेश्वर
Vishwa	विश्व
Vishwnath	विश्वनाथ
Visisht	विशिष्ट
Viswanath	विश्वनाथ
Vita	वीटा
Vitthala	विठ्ठला
Viv	विव
Viveka	विवेका
Vivekaa	विवेका
Vivekaanand	विवेकानंद
Vivi	विवी
Vivienne	विविएन
Vlora	वलोरा
Vmoksha	विमोक्ष
Vocaltec	वोकलटेक
Vodafone	वोडाफोन
Vogel	वोगेल
Volga	वॉल्गा
Volga	वोल्गा
Voltas	वोल्टास
Volvo	वॉल्वो
Vonda	वोंडा
Vonhagt	वॉन्हग्ट
Vorpommern	वोर्पोमेर्न
Voyager	वॉयेजर
Vraaki	व्राकी
Vrahat	वृहत
Vrajabala	व्रजबाला
Vraksharaaj	वृक्षराज
Vrashti	वृष्टि
Vyakhya	व्याख्या
Vyanjana	व्यंजना
Vyapak	व्यापक
Vyapt	व्याप्त
Vyom	व्योम
Vyomesh	व्योमेश
Wachovia	वैकॉविया
Wacoal	वैकोल
Wada	वाडा
Wada	वादा
Wadden	वैडन
Wade	वादे
Wadi	वाडी
Wafa	वफा
Wafi	वाफी
Wafiq	वफि़क
Wahadat	वहादत
Wahb	वाहब
Wahban	वाहबान
Wahhaab	वहाब
Waisi	वैसी
Waiz	वैज
Wajeeh	वजीह
Wajihah	वजीहाह
Wakeel	वकील
Walawe	वालावे
Waldegrave	वैल्डेग्रेव
Waldo	वाल्डो
Wale	वाले
Walecha	वलेचा
Walee	वली
Wales	वेल्स
Wali	वली
Wali	वाली
Walia	वालिया
Waliyah	वलियाह
Walk	वॉक
Walkley	वॉक्ले
Wallace	वैलेस
Wallece	वैलेस
Wally	वैली
Walo	वालो
Walt	वॉल्ट
Walters	वाल्टर्स
Waltz	वाल्ट्ज
Wapusk	वापुस्क
Waqar	वकार
Waqt	वक्त
War	वार
Warangal	वारंगल
Warnapura	वर्नापुरा
Warner	वार्नर
Warner	वॉर्नर
Warren	वारेन
Warrior	वारियर
Warsaw	वारसो
Warsaw	वॉर्सा
Wasan	वसन
Wasatch	वासाच
Waseefah	वसीफाह
Waseemah	वजीमाह
Washington	वॉशिंगटन
Washington	वॉशिंग्टन
Wasifah	वसीफाह
Wasilah	वसीलाह
Wasna	वास्ना
Wassan	वास्सान
Wasti	वस्ती
Watan	वतन
Water	वाटर
Water	वॉटर
Waterphone	वाटरफोन
Waterton	वॉटरटॉन
Watt	वॉट
Waverly	वेवर्ली
Wawona	ववोना
Way	वे
Waylon	वेलॉन
Wayne	वेन
Wazeera	वजीरा
Weaving	विविंग
Webby	वैबी
Webster	वेबस्टर
Webzen	वेब्झेन
Weeraratne	वीररत्ने
Wein	वेन
Well	वेल
Wellham	वेल्हैम
Wellpoint	वेलपॉईंट
Welsh	वेल्श
Wenda	वेंडा
Wendi	वेंडी
Wentworth	वेंटवर्थ
Wes	वेस
Wesley	वेस्ली
Wesleyan	वेस्लेयान
Westbrook	वेस्टब्रूक
Western	वेस्टर्न
Westminster	वेस्टमिनस्टर
Westmoreland	वेस्टमोरलैंड
Wettimuny	वेट्टीमुनी
Wheaton	व्हीटन
Wheeler	व्हीलर
Whirlpool	व्हर्लपूल
Whitby	व्हाईटबाय
Whitcomb	व्हाइटकॉम्ब
White	व्हाइट
Whitfield	व्हाइटफील्ड
Whittaker	व्हाइटेकर
Whittaker	व्हिटेकर
Who	वो
Whoopi	व्हूपी
Whyeth	व्हेथ
Wickerson	विकर्सन
Wicklow	विक्लोव
Wickramaratne	विक्रमारत्ने
Wickramasinghe	विक्रमासिंघे
Wickremasinghe	विक्रमासिन्घे
Wiener	वीनर
Wiener	वेनर
Wilbur	विल्बर
Wilder	वाइल्डर
Wilderness	विल्डरनेस
Wildewood	वाइल्डवुड
Wilford	विल्फोर्ड
Wilfred	विल्फ्रेड
Wilhelm	विल्हेम
Wilhelmina	विलहेल्मिना
Wilhem	विल्हेम
Willa	विला
Willis	विलिस
Willoughby	विलॉघबाय
Willoughby	विलौघबी
Wilma	विल्मा
Wilmet	विल्मेट
Wilona	विलोना
Wilton	विल्टन
Winder	विंडर
Winfre	विन्फ्रे
Winger	विंजर
Winifred	विनिफ्रेड
Winnie	विनी
Winona	विनोना
Winslow	विनस्लो
Winthrop	विंथ्रोप
Winup	विनअप
Wireless	वायरलेस
Wirt	वर्ट
Wisconsin	विस्कॉनसिन
Wiseman	वाइसमैन
Wisma	विस्मा
Wolseley	वॉल्सेले
Wolverine	वॉल्वरिन
Wonder	वन्डर
Wood	वुड
Wood	वूड
Woodcock	वुडकॉक
Wooden	वूडेन
Woodlands	वुडलैंड्स
Woodstock	वुडस्टॉक
Woody	वूडी
Woogie	वूगी
Woolmer	वूल्मर
Woorkeri	वूर्करी
Word	वर्ड
Word	वर्ल्ड
Worden	वॉर्डन
Wordsworth	वर्ड्सवर्थ
World	वर्ल्ड
Worst	वर्स्ट
Wozniak	वॉजनिक
Wrangell	व्रैंगेल
Wreck	व्रेक
Wren	रेन
Wright	राइग्ट
Wurttemburg	वूटेनबर्ग
Wycliff	वायक्लिफ
Wyeth	विथ
Wyk	वीक
Wyndham	विंडहाम
Wyomina	व्योमिना
Xander	झेंडर
Xannon	झेनन
Xanthe	जांथे
Xanthi	झैन्थी
Xanthus	जेंथस
Xanti	जेंटी
Xanto	जेंटो
Xaviera	जेविएरा
Xenophon	क्झेनोफोन
Xerxes	जेरक्सेस
Xexilia	जेजिलिया
Xingu	झींगू
Xongo	झोंगो
Xylophone	क्झिलोफोन
Ya	या
Yaachanaa	याचना
Yaachishnu	याचिष्णु
Yaachit	याचित
Yaad	याद
Yaaminee	यामिनी
Yaar	यार
Yaaron	यारो
Yaasameen	यासमीन
Yaasmeen	यास्मीन
Yaatna	यातना
Yablonoi	याब्लोनोई
Yadav	यादव
Yadavindra	यादविंद्र
Yaghnam	यघनाम
Yagyamaan	यज्ञमान
Yahan	यहा
Yahya	यहया
Yahya	याह्या
Yaju	यजु
Yalqoot	यलकूत
Yamaha	यमाहा
Yamasee	यमासी
Yamashiro	यमाशिरो
Yaminah	यमीनाह
Yaminee	यामिनी
Yamini	यामिनी
Yamunanagar	यमुनानगर
Yang	यंग
Yang	यांग
Yaqoot	यकूत
Yaraana	याराना
Yashavant	यशवंत
Yashila	यशीला
Yashima	यशिमा
Yashodha	यशोधा
Yashomati	यशोमती
Yashpal	यशपाल
Yasmine	यास्मिन
Yasuda	यसुदा
Yatee	यती
Yati	यति
Yatindra	यतींद्र
Yatishwar	यतीश्वर
Yawar	यावर
Years	ईयर्स
Yeh	यह
Yeh	ये
Yehi	यही
Yeldari	येल्दारी
Yelena	येलेना
Yellowstone	येल्लोस्टोन
Yeltsin	येल्तसिन
Yenisei	येनीसेय
Yennenga	येनेन्गा
Yitzhak	यिट्जहॅक
Yogavati	योगवति
Yogeey	योगीय
Yogendra	योगेंद्र
Yogeshvar	योगेश्वर
Yogeshwar	योगेश्वर
Yogini	योगिनी
Yogish	योगीश
Yograj	योगराज
Yohannan	योहानन
Yoho	योहो
Yoko	योको
Yoland	योलैन्ड
Yomiuri	योमियुरी
York	यॉर्क
Yorktown	यॉर्कटाउन
Yosemite	योजमाइट
Young	यंग
Younis	युनिस
Younis	यूनिस
Yousuf	यूसुफ
Ytterbium	अटर्बियम
Yuddh	युद्ध
Yudha	युध
Yug	युग
Yugoslavia	युगोस्लाविया
Yuhannis	युहान्निस
Yuktaa	युक्ता
Yusen	यूसेन
Yusr	युस्र
Yuvaraaj	युवराज
Yvette	वेट्टी
Yvonne	वॉन्नी
Zabrina	जैबरीना
Zachary	झकरी
Zada	जादा
Zadi	जादी
Zafirah	झफीराह
Zahed	जाहेद
Zahid	जाहिद
Zahidah	जहीदाह
Zahirah	जहिराह
Zahra	जाहरा
Zahringen	जहरिंगन
Zainabad	जैनाबाद
Zakhmi	जख्मी
Zakirah	जकीराह
Zalil	जलील
Zamana	जमाना
Zamane	जमाने
Zambezi	जाम्बेजी
Zameen	जमीन
Zamrud	जमरुद
Zander	जेंडर
Zandra	जेंड्रा
Zandunga	जेन्डूंगा
Zanjeeer	जंजीर
Zanjeer	जंजीर
Zanjeeren	जंजीरे
Zanna	झेन्ना
Zapateado	जपाटेडो
Zapatta	जपाट्टा
Zaporizhian	झेपोरीझीआन
Zareenah	जरीनाह
Zarka	झर्का
Zarqa	जर्का
Zaytoon	जैतून
Zea	जिया
Zee	झी
Zeenat	झीनत
Zeilin	जेलिन
Zelda	जेल्डा
Zenobia	झेनोबिया
Zesers	जेसर्स
Zeus	जिउस
Zeven	ज़ेवेन
Zhukov	झूकोव
Zinc	झिंक
Zinda	जिंदा
Zindabad	जिंदाबाद
Zinna	जिन्ना
Zoe	जोय
Zoehrer	जोहरर
Zoie	ज़ोइ
Zoltin	जोल्टिन
Zrinyi	ज्रिंई
Zuari	जुआरी
Zubair	जुबैर
Zufar	जुफार
Zuiho	जुइहो
Zulqarnain	जुल्करनैन
Zygomalas	जायगोमेलस
Zyl	जिल
Zyta	जीटा
