Aadhi	ஆதி
Aakash	ஆகாஷ்
Aap	ஆப்
Aayasha	ஆயாஷா
Aayee	ஆயி
Abduh	அப்துஸ்
Aberhart	அபெர்ஹார்ட்
Abey	அபே
Abou	அபூ
Abri	அப்ரி
Academy	அகாடெமி
Accommodation	அக்காமடேஷன்
Acorn	அகார்ன்
Adams	ஆடம்ஸ்
Adgaon	அட்காவுன்
Adlabs	ஆட்லாப்ஸ்
Agro	அக்ரோ
Ahlaad	அஹ்லாத்
Air	அல்ர்
Aisin	ஐசின்
Ajee	அஜீ
Ajhai	அஜ்ஹாய்
Ajith	அஜித்
Akaram	அகரம்
Akele	அகேலே
Akhri	அக்ரி
Akodia	அகோடியா
Akurdi	அகுர்தி
Alas	அலாஸ்
Albany	ஆல்பனி
Albany	அல்பானி
Alester	அலிஸ்டர்
Alex	அலெக்ஸ்
Alipur	அலிபூர்
Alkali	அல்கலி
Alpesh	அல்பேஷ்
Amanat	அமானத்
American	அமெரிக்கன்
Amodini	அமோதினி
Andha	அந்தா
Angel	ஏஞ்சல்
Anna	அன்னா
Anne	ஆன்னெ
Antibody	ஆன்டிபாடி
Aon	ஏவோன்
Apne	அப்னே
Araafat	அராஃபாத்
Aries	ஏரீஸ்
Ark	ஆர்க்
Arman	அர்மான்
Arms	ஆர்ம்ஸ்
Arnott	ஆர்னாட்
Arsikere	ஆர்சிகேரே
Art	ஆர்ட்
Arthurton	ஆர்தர்டன்
Ashoka	அசோக
Ashram	ஆஷ்ரம்
Asperen	ஆஸ்பெரென்
Astle	ஆஸ்டில்
Athey	அதே
Ati	ஆதி
Auckland	ஆக்லேண்ட்
Audaen	ஆடாயென்
Auliya	ஆலியா
Austro	ஆஸ்டிரோ
Aveline	அவேலின்
Awards	அவார்ட்ஸ்
Awra	ஆவ்ரா
Aybak	அய்பக்
Ayengi	ஆயேங்கி
Baagul	பாகுல்
Baan	பான்
Baat	பாத்
Bada	பாதா
Badamash	பாதாமாஷ்
Bader	பாதர்
Badho	படோ
Badmashon	பத்மாஷோன்
Baghdadi	பாக்தாதி
Baharwali	பஹர்வாலி
Balamani	பாலமணி
Baldrige	பால்ட்ரிஜ்
Balkham	பால்காம்
Balvant	பல்வந்த்
Bamori	பமோரி
Bandaratilleke	பண்டாரதிலகே
Bandopadyay	பந்தோபாத்யாய்
Banshlai	பன்ஷ்லாய்
Baori	பவோரி
Baraigram	பராய்க்ராம்
Barney	பார்னே
Barsao	பர்சாவோ
Basere	பசேரே
Batti	பாட்டி
Batu	படு
Bayazid	பாயாஸீத்
Bazar	பஜார்
Beacon	பெக்கான்
Been	பீன்
Beethoven	பீத்தோவன்
Begam	பேகம்
Begum	பேகம்
Behram	பெஹ்ராம்
Bembridge	பெம்பிரிட்ஜ்
Bengal	பெங்கால்
Benito	பெனிட்டோ
Bensonvale	பென்ஸஂவலே
Berendrecht	பெரென்டிரெச்ட்
Beta	பேட்டா
Bete	பேடெ
Bey	பே
Bha	பா
Bhabi	பாபி
Bhakt	பக்த்
Bhanjan	பன்ஜன்
Bharose	பாரோஸ்
Bharuch	பாருச்
Bhatnagar	பட்னாகர்
Bhaujai	புஜாயி
Bhed	பெத்
Bhool	பூல்
Bhuvaneswari	புவனேஸ்வரி
Bibhor	பிபோர்
Bijani	பிஜானி
Bikhare	பிகாரே
Bikrom	பிக்ரம்
Bilhar	பில்ஹார்
Bill	பில்
Bilson	பில்சன்
Biochem	பயோகெம்
Biraj	பிரஜ்
Bisalwas	பிசல்வாஸ்
Blackwell	பிளாக்வெல்
Blicks	ப்ளிக்ஸ்
Blignaut	ப்ளிக்னாட்
Blind	ப்ளைண்ட்
Bocher	போச்சர்
Body	பாடி
Boeta	பீட்டா
Boje	ஹோயே
Boo	பூ
Book	புக்
Border	பார்டர்
Bosch	போஷ்
Bowles	பௌல்ஸ்
Bracewell	பிரேஸ்வெல்
Brahman	ப்ராஹ்மன்
Brahmanya	பிரம்மன்ய
Breese	ப்ரீஸ்
Breton	ப்ரேடன்
Brewery	ப்ரூவேரி
Briant	ப்ரயண்ட்
Bromo	ப்ரோமோ
Brooke	ப்ரூக்
Bros	ப்ரதர்ஸ்
Brothers	ப்ரதர்ஸ்
Brownlow	ப்ரவுன்லோ
Brunel	ப்ரூனல்
Buckland	பக்லாண்ட்
Bulfin	பலஃப்பின்
Bureau	பியோரே
Burmah	பர்மா
Bush	புஷ்
Buy	பை
Byron	பைரன்
Calgary	கால்காரி
Campbell	காம்ப்பெல்
Canadas	கனடாஸ்
Capone	கபோன்
Caring	கேரிங்
Carry	கேரி
Caulfield	கால்ஃபீல்ட்
Chadar	சதர்
Chakaradhari	சக்ரதாரி
Champlain	சாம்ப்ளெய்ன்
Changez	சேஞ்சஸ்
Chankanab	சங்கநாப்
Chapel	சாப்பல்
Charith	சரித்
Chartres	சார்டிரெஸ்
Chartreuse	சார்ட்டிரூயிஸ்
Chassis	சேசிஸ்
Chatfield	சாட்ஃப்பீல்ட்
Chatterjee	சாட்டர்ஜீ
Chatterji	சாட்டர்ஜி
Chaudury	சௌத்ரி
Chaylse	சேய்ல்ஸ்
Cheer	சியர்
Chemical	கெமிக்கல்
Chennakesava	சென்னகேசவ
Chhoo	சஹூ
Chilbila	சில்பலா
Chipewyan	சிப்வய்ன்
Chirstian	கிரிஸ்டியன்
Choice	சாய்ஸ்
Cholvaram	சோல்வரம்
Choron	சோரன்
Chorvad	சோர்வாட்
Chronicle	கிரானிக்கல்
Churchill	சர்ச்சில்
Chyulu	சியூலு
Cidades	சிடாடெஸ்
Cimatario	சிமாடாரியோ
Citadel	சிட்டாடெல்
Coat	கோட்
Coca	கோகோ
Coffee	காஃபி
Cola	கோலா
Colour	கலர்
Commandante	கம்மான்டன்டெ
Computers	கம்ப்யூட்டர்ஸ்
Condecoracion	காண்டெஷோரேசியன்
Condoleeza	காண்டோலீசா
Consolidated	கன்சாலிடேட்டட்
Coolagh	கூலாக்
Copco	காப்கோ
Corazon	காராசோன்
Cosier	கோஸியர்
Count	கவுண்ட்
Cref	கிரெப்
Cronje	க்ரோன்ஜ்
Crookhorn	க்ரூக்ஹார்ன்
Crossing	கிராசிங்
Crown	கிரவுன்
Culture	கல்ச்சர்
Curtly	கோர்ட்லி
Cyber	சைபர்
Daal	தால்
Dabhoi	தபோய்
Dabli	தாப்லி
Daegu	டாயிகு
Daghfal	டக்ஃபால்
Dahade	தஹாதே
Dahesh	டாஹெஷ்
Dai	டை
Dalrymple	டால்ரிம்பிள்
Damdama	தம்தனா
Dannie	டேனி
Dapeng	டேபெங்
Daryl	டாரில்
Daur	தெளர்
David	டேவிட்
Davies	டேவிஸ்
Day	டே
Dead	டெட்
Decembre	டிசம்பர்
Deewane	தீவானே
Deirdre	தேய்ர்த்ரே
Deke	தேகே
Dekh	தேக்
Dena	தேனா
Denzel	டென்சல்
Depot	டிப்போ
Deryck	டெரிக்
Des	டிஸ்
Desoto	டிசோடோ
Devdas	தேவதாஸ்
Devdas	தேவ்தாஸ்
Dhahir	தாஹிர்
Dhalaibil	தலாய்பில்
Dhari	தாரி
Dhobari	தோபரி
Diamond	டயமண்ட்
Dibosh	திபோஷ்
Dickman	டிக்மேன்
Dike	டைக்
Dilhara	தில்ஹாரா
Dilwale	தில்வாலே
Dina	தினா
Dior	டயர்
Diplomatic	டிப்ளொமேடிக்
Disabled	டிசேபில்ட்
Disk	டிஸ்க்
Disney	டிஸ்னி
Dlink	டிலிங்க்
Dodi	டோடி
Doll	டால்
Dongargarh	தொண்டார்கார்
Donnanview	டோனன்வியூ
Dono	தோனோ
Doolha	தூல்ஹா
Drama	ட்ராமா
Dravid	திராவிட்
Drawing	டிராயிங்
Dripping	டிரிப்பிங்
Drive	டிரைவ்
Drucilla	ட்ரூசில்லா
Dukakis	துகாகிஸ்
Dulip	துலீப்
Dwarikesh	த்வாரிகேஷ்
Dymock	டைமாக்
Eddo	எட்டோ
Edger	எட்கர்
Edmonds	எட்மண்ட்ஸ்
Egmore	எக்மோர்
Egyptian	இஜிப்டியன்
Einstein	ஐன்ஸ்டின்
Elbit	எல்பிட்
Elder	எல்டர்
Elders	எல்டர்ஸ்
Ellan	எலான்
Elmer	எல்மெர்
Elong	ஈலாங்
Emburey	எம்புரே
Enterprises	என்டர்பிரைசஸ்
Erhard	எர்ஹார்ட்
Eric	எரிக்
Ervine	எர்வைன்
Erwin	எர்வின்
Erzherzog	எர்ஸர்ஸாக்
Estonian	எஸ்டோனியன்
Estrella	எஸ்ட்ரெல்லா
Etemad	எடிமாத்
Eugenia	இயுஜினிய
Explor	எக்ஸ்ப்ளோர்
Eyed	ஐட்
Fantasy	ஃபேண்டஸி
Fargo	பார்கோ
Fasteners	ஃபாஸ்ட்னர்ஸ்
Fazal	ஃபாசல்
Fazl	ஃப்பாஸ்ல்
Fernado	ஃபெர்னாண்டோ
Ferrero	ஃபெரேரோ
Ferro	ஃபெர்ரோ
Fond	ஃப்பாண்ட்
Fredricka	ஃப்ரெடரிகா
Frissiras	ஃப்பிர்ஸ்ஸிரஸ்
Frontier	ஃப்பிரான்டியர்
Gadag	கடக்
Gadra	கட்ரா
Galaxidi	காலாக்ஸிடி
Galileo	கலிலியோ
Gallants	கால்லன்ட்ஸ்
Gambhiri	கம்பீரி
Ganagapur	கனகாபூர்
Ganegama	கனிகாமா
Garam	கரம்
Garm	கரம்
Garner	கார்னர்
Gauss	காஸ்
Gautama	கௌதம
Gauvin	கவின்
Geraldene	ஜெரால்டீன்
Gerita	கெரிட்டா
Germanium	ஜெர்மானியம்
Ghanvatkar	கன்வத்கர்
Ghazali	காஸாலி
Ghoda	கோதா
Ghorakhal	கோராகால்
Ghule	குலே
Gifford	கிஃப்போர்ட்
Gladys	கிலாடிஸ்
Glamorgan	க்ளாமோர்கன்
Globe	க்ளோப்
Gokhale	கோகேல்
Gokte	கோக்தே
Gombe	கோம்பே
Goncourt	கான்கோர்ட்
Gorshkov	கார்ஷ்காவ்
Gossaigaon	கோஸாய்காவுன்
Goswami	கோஸ்வாமி
Govindnagar	கோவிந்த்நகர்
Graf	கிராஃப்
Gray	க்ரே
Grentech	கிரென்டெக்
Greville	கிரெவில்லே
Gross	கிராஸ்
Gudha	குத்தா
Gudha	குதா
Gujarat	குஜ்ராத்
Gulabi	குலாபி
Gulf	கல்ஃப்
Gunderippalam	குண்டெரிபள்ளம்
Gvk	ஜிவிகே
Haamid	ஹாமித்
Hafeez	ஹஃபீஸ்
Haley	ஹேலி
Half	ஹாஃப்
Hamamah	ஹமாமா
Hanste	ஹன்ஸ்டே
Hara	ஹாரா
Harsingar	ஹர்ஸிங்கர்
Harvey	ஹார்வி
Harwich	ஹார்விச்
Hatao	ஹடோ
Hayy	யேய்
Heeron	ஹீரோன்
Hells	ஹெல்ஸ்
Hemmings	ஹெம்மிங்க்ஸ்
Higher	ஹையர்
Hilfiger	ஹிலஃபிஜர்
Hill	ஹில்
Hillcrest	ஹில்கிரேஸ்ட்
Hindustan	ஹிந்துஸ்தான்
Hisaab	ஹிசாப்
Hiyo	ஹியோ
Hogg	ஹூக்
Holder	ஹோல்டர்
Hole	ஹோல்
Holiday	ஹாலிடே
Homestead	ஹோம்ஸ்டெட்
Honda	ஹோன்டா
Hone	ஹோன்
Hoon	ஹூன்
Hosanna	ஹோஸன்னா
Hub	ஹப்
Huddersfield	ஹட்டர்ஸ்ஃபீல்ட்
Hugli	ஹூக்லி
Hull	ஹல்
Humari	ஹமாரி
Humpage	ஹப்பேஜ்
Hunaydah	ஹுனய்தா
Hundred	ஹண்டிரெட்
Hunt	ஹண்ட்
Husn	ஹஸன்
Hydrogenics	ஹைடிரோஜீனிக்ஸ்
Ibadat	இபாதத்
Icahn	இகான்
Igglesden	இக்லெஸ்டென்
Image	இமேஜ்
Inam	இனாம்
Indukaant	இந்துகன்ந்த்
Ingersoll	இங்கர்சால்
Insaf	இன்சாஃப்
Instruction	இன்ஸ்ட்ரக்ஷன்
Intercontinental	இண்டர்காண்டினண்டல்
International	இண்டர்நேஷநல்
Irishmen	ஐரிஷ்மென்
Isle	ஐல்
Istvan	இஸ்ட்வான்
Italiano	இட்டாலினோ
Itawa	இடாவா
Iventure	இவென்ச்சுர்
Jaafaree	ஜாஃபாபீ
Jaani	ஜானி
Jaarsveld	ஜார்ஸ்வெல்ட்
Jacob	ஜேக்கப்
Jahrousse	ஜாரவுசே
Jaise	ஜெய்சே
Jaitu	ஜெய்டூ
Jalti	ஜல்தி
Jamai	ஜமாய்
Jamda	ஜாம்தா
Janasadharan	ஜனாசாதாரன்
Janjgir	ஜஞ்கிர்
Javagal	ஜவாகல்
Jayanagar	ஜெயாநகர்
Jayantha	ஜெயந்தா
Jayaprakashdaran	ஜெயப்ரகாஷ்தரண்
Jecy	ஜெசி
Jeeo	ஜீயோ
Jeeta	ஜீதா
Jet	ஜெட்
Jewish	ஜீவிஷ்
Jhuk	ஜுக்
Jhukenge	ஜுகேங்கே
Jhukta	ஜுக்தா
Jilani	ஜிலானி
Jim	ஜிம்
Jin	ஜின்
Jo	ஜோ
Jodhpuri	ஜோத்பூர்
Johan	ஹோஹன்
Judge	ஜட்ஜ்
Jwar	ஜ்வார்
Jyotiba	ஜோதியா
Jyotirlinga	ஜோதிர்லிங்க
Kaala	காலா
Kaamil	காமில்
Kaashi	காஷி
Kab	கப்
Kabira	கபிரா
Kajaria	கஜாரியா
Kalpage	கல்பகே
Kambli	காம்ப்ளி
Kanaklata	கனக்லாடா
Kandamby	கண்டாம்பி
Kandaswamy	கந்தசாமி
Kandh	கந்த்
Kanengara	கனேங்கரா
Kaneria	கனேரியா
Kanhaiya	கன்ஹையா
Kante	கண்டே
Kanya	கன்யா
Karamah	கரமா
Karanjwan	கரஞ்வன்
Karega	கரேகா
Karl	கார்ல்
Karoonga	கரூன்கா
Karwa	கர்வா
Kasturi	கஸ்தூரி
Katilon	கதிலோன்
Katse	கத்ஸே
Kawachi	கவாச்சி
Kazim	காஸிம்
Keats	கீட்ஸ்
Kenedy	கென்னடி
Kennedy	கென்னடி
Kenosha	கெனோஷ
Kerr	கெர்
Kettle	கெட்டில்
Ketu	தேது
Khaled	காலெத்
Khana	கன்னா
Khayriyah	கேரியா
Khayyam	காய்யம்
Khelte	கேல்டே
Khoda	கோடா
Khooni	கூனி
Khufia	குஃப்பியா
Kijkuit	கிஜ்கூயித்
Killarney	கில்லார்னி
Kirmani	கிர்மானி
Kis	கிஸ்
Kise	கிஸே
Kisi	கிஸி
Kissa	கிஸ்ஸா
Kitne	கித்னே
Klusener	க்ளூஸ்னர்
Kol	கோல்
Kon	கோன்
Korene	கோரீன்
Kosan	கோசன்
Koto	கோட்டோ
Krebs	க்ரெப்ஸ்
Kris	கிரிஸ்
Kulasekara	குலசேகரா
Kutte	குட்டெ
Kyonji	க்யோன்ஜி
Lac	லாக்
Lajwati	லஜ்வதி
Lakshmipathy	லக்ஷ்மிபதி
Lal	லால்
Land	லாண்ட்
Lanen	லேனன்
Las	லாஸ்
Lasker	லாஸ்கர்
Layegi	லாயேகி
Lehmann	லெஹ்மேன்
Lei	லேய்
Lenge	லெங்கே
Letters	லெட்டர்ஸ்
Lever	லிவர்
Leyland	லேலண்ட்
Light	லைட்
Lindy	லின்டி
Lisa	லிசா
Lobachevsky	லோபாசெவ்ஸ்கி
Loha	லோஹா
Lok	லோக்
Loydchiles	லாய்ட்சைல்ஸ்
Lucky	லக்கி
Luitpold	லுயிட்போல்ட்
Luther	லுதர்
Lynn	லின்
Lytton	லைட்டன்
Maahir	மாஹிர்
Maange	மாங்கெ
Maar	மார்
Macewen	மேக்வென்
Mackay	மக்காய்
Mad	மாட்
Madari	மடாரி
Madine	மதினெ
Magna	மாக்னா
Mah	மஹாரஷ்ட்ரா
Mahajabeen	மஹஜபீன்
Mahapatra	மஹாபாத்ரா
Mahommed	மஹோமெத்
Mail	மெயில்
Mal	மால்
Malka	மல்கா
Maluku	மலுகு
Mamta	மம்தா
Manikpur	மாணிக்பூர்
Manjural	மன்ஜுரல்
Mannar	மன்னர்
Mansoor	மன்சூர்
Marcantonio	மார்கான்டோனியோ
Marchais	மார்சைஸ்
Marie	மேரி
Marjina	மர்ஜினா
Marudhanadhi	மருதாநதி
Masjid	மஸ்ஜித்
Mason	மேசன்
Matav	மட்டவ்
Mathew	மத்தேயு
Matt	மாட்
Mattis	மாட்டிஸ்
Maunsell	மவுன்செல்
Mawenge	மவேங்கா
Mawlana	மாவ்லானா
Mcclary	மெக்கிளாரி
Meda	மீடா
Meghdoot	மேக்தூத்
Meher	மெஹெர்
Mehrab	மெஹ்ராப்
Mei	மே
Melleha	மெலெஹா
Memorial	மெமோரியல்
Menara	மேனரா
Mengkuang	மெங்முவாங்
Mera	மேரா
Mere	மேரெ
Merit	மெரிட்
Merrill	மெரில்
Metal	மெட்டல்
Meth	மெத்
Methuselah	மெதுசெலா
Mexican	மெக்சிகன்
Meyrick	மெய்ரிக்
Mhale	மாலே
Michener	மிஷனர்
Micholi	மிசோலி
Middleton	மிடில்டன்
Milai	மிலாய்
Minto	மிண்டோ
Mitcham	மிட்சாம்
Mitenge	மிடேங்கே
Mitsubishi	மிட்சுபீஷி
Moinuddin	மோய்னுத்தீன்
Monsanto	மொன்சாண்டோ
Montshire	மான்ட்ஷைர்
Morosini	மொரோசினி
Morro	மோரோ
Moultrie	மெளட்டிரி
Mouth	மவுத்
Mozart	மொசார்ட்
Mrinali	ம்ரினாலி
Mujeeb	முஜீப்
Mulhouse	முல்ஹவுஸ்
Multi	மல்டி
Muneem	முனீம்
Munsif	முன்சிஃப்
Muralitharan	முரளிதரண்
Murdoch	முர்டோச்
Mushfiqur	முஷ்ஃப்பிகுர்
Mutahharah	முதாஹாரா
My	மை
Naami	நாமி
Naate	நாதே
Nagamootoo	நாகமுத்து
Nahin	நஹின்
Nakhimov	நாக்கிமோவ்
Nansen	நான்சன்
Nascopie	நாஸ்கோபி
Nasheen	நஷீன்
Nawaz	நவாஸ்
Naya	நயா
Nazar	நஸார்
Neeli	நீலி
Neera	நீரா
Netravati	நேத்ரவதி
Night	நைட்
Nightingale	நைட்டிங்கேல்
Nikita	நிகிதா
Nimrod	நிம்ரோத்
Nirdoshi	நிர்தோஷி
Nishchay	நிஷ்சாய்
Nolte	நோல்டே
Noord	நூர்த்
Northern	நார்தர்ன்
Northumbria	நார்த்தம்ப்ரியா
Nottingham	நாட்டிங்காம்
Novamerican	நோவாமெரிக்கன்
Oldonyo	ஓல்டோன்யோ
Oonch	ஊன்ச்
Or	ஆர்
Orly	ஓர்லி
Ormula	ஆர்முலா
Osamu	ஒசாமு
Overland	ஓவர்லேண்ட்
Paandu	பாண்டு
Painter	பெயிண்டர்
Palanca	பலான்கா
Palung	பலுங்
Panama	பனாமா
Pantanal	பாண்டலால்
Papps	பாப்ஸ்
Par	பார்
Parcel	பார்சல்
Parineeta	பரினீதா
Parkar	பர்கர்
Parks	பார்க்ஸ்
Parthiv	பர்த்திவ்
Parvat	பர்வத்
Pascoal	பாஸ்கோல்
Pasina	பஸினா
Pasqual	பாஸ்கல்
Patnee	பாட்னீ
Patton	பேட்டன்
Pauls	பால்ஸ்
Pavarotti	பவாரோட்டி
Paying	பேயிங்
Payod	பயோத்
Peach	பீச்
Pearsall	பியர்சால்
Pearson	பியர்சன்
Pentamedia	பெண்டாமீடியா
Peoples	பீப்புள்ஸ்
Person	பர்சன்
Peters	பீட்டர்ஸ்
Peterson	பீட்டர்சன்
Philo	ஃபிலோ
Phoolvati	பூல்வதி
Photo	போட்டோ
Photography	போட்டோகிராபி
Pick	பிக்
Picnic	பிக்னெக்
Piet	பியட்
Place	பிளேஸ்
Plate	ப்ளேட்
Pollock	பொல்லாக்
Polydex	பாலிடெக்ஸ்
Pontiacs	போன்டியாக்ஸ்
Pontisse	பான்டிஸ்ஸே
Poori	பூரி
Pope	போப்
Portela	போர்டெலா
Poste	போஸ்டே
Prabhati	பிரபாதி
Prachur	ப்ரசுர்
Pramodya	ப்ரோமோத்யா
Pregl	ப்ரெகல்
Premio	ப்ரீமோ
Presernova	ப்ரெசெர்நோவா
Press	பிரெஸ்
Priest	பிரீஸ்ட்
Print	பிரிண்ட்
Professional	ப்ரொஃபஷனல்
Profiles	ப்ரொஃபைல்ஸ்
Provincien	புரோவிஷியன்
Pruth	ப்ரூத்
Publix	பப்ளிக்ஸ்
Pucca	பக்கா
Pukarega	புகரேகா
Punja	புன்ஞா
Purab	புரப்
Purani	புரானி
Puroskar	புரோஸ்கர்
Purvoday	புர்வோதே
Purza	புர்ஸா
Pyare	பியாரே
Qin	கின்
Quad	க்வாட்
Quality	க்வாலிட்டி
Quanoon	குவானூன்
Quarban	குர்பன்
Quila	கிளா
Rada	ராடா
Ragoonath	ரகுநாத்
Rahmah	ரஹ்மா
Raho	ரஹோ
Rahu	ராஹூ
Rain	ரெயின்
Raina	ராய்னா
Rajesh	ராஜேஷ்
Rajhara	ராஜ்ஹாரா
Rakhra	ரக்ரா
Ramco	ராம்கோ
Ramdin	ராம்தின்
Ranchi	ரான்சி
Rangeeli	ரங்கீலி
Rangeen	ரங்கீன்
Rangile	ரங்கிலே
Raqibul	ரஃப்பிகுல்
Rashk	ரஷ்க்
Rastriya	ராஷ்டிரியா
Reddys	ரெட்டிஸ்
Refin	ரிஃபைன்
Rennie	ரென்னி
Research	ரிசர்ச்
Right	ரைட்
Rim	ரிம்
Ripper	ரிப்பர்
Ritchie	ரிட்ச்சீ
Robinhood	ராபின்ஹூட்
Ronduit	ரான்டுயிட்
Roopaa	ரூபா
Rootha	ரூதா
Ruka	ருகா
Rush	ருஷ்
Ruth	ரூத்
Ruzyne	ருசைன்
Ryan	ரையன்
Ryanair	ரையனைர்
Ryder	ரைடர்
S	எஸ்
Saab	சாப்
Sachai	ஸசாயி
Sadashiv	சதாஷிவ்
Sadeem	சதீம்
Sadhana	சாதனா
Sadra	சாத்ரா
Safiyyah	சஃபிய்யா
Saful	சஃபுல்
Said	சயித்
Saiful	சைஃப்புல்
Saigal	சைகல்
Sainte	செயிண்டெ
Saleh	சாலேஹ்
Sama	சமா
Sammy	சாமி
Sanawbar	சனவ்பார்
Sanitary	சானிட்டரி
Sanket	சங்கெத்
Sap	எஸ்ஏபி
Sapera	சாபெரா
Sapera	சபேரா
Sariyah	சரியா
Sarovar	சரோவர்
Satta	சத்தா
Sattaar	சத்தார்
Satte	சத்தே
Savu	சவு
Sawar	சாவார்
Saymukta	சய்முக்தா
Schuyler	ஸ்சுய்லெர்
Scissor	சிசர்
Scorpio	ஸ்கார்பியோ
Scottish	ஸ்காட்டிஷ்
Sebastien	செபாஸ்டியன்
Seblat	செப்லாத்
Secunderabad	செக்குந்திராபாத்
Seedha	சீதா
Seekh	சீக்
Sei	சீ
Seiki	சைகி
Seinfeld	சீன்ஃபீல்ட்
Selleck	செல்லக்
Senior	சீனியர்
Serjeant	செர்ஜியண்ட்
Seth	சேத்
Shaanxi	ஷான்க்ஸி
Shahdara	ஷதாரா
Shakespeare	ஷேக்ஸ்பியர்
Sham	ஷாம்
Shamshera	ஷம்ஷேரா
Shanda	ஷான்டா
Shani	ஷானி
Shatrujay	ஷத்ருஞ்சய்
Shaukat	ஷௌகத்
Shaul	ஷௌல்
Sheehy	ஷீஹி
Sheetla	ஷீத்லா
Sheikh	ஷேக்
Shek	ஷேக்
Sheridan	ஷெரிடன்
Sherwin	ஷெர்வின்
Shillingford	ஷில்லிங்ஃபோர்ட்
Shivaji	ஷிவாஜி
Shivam	ஷிவம்
Shokh	ஷோக்
Shravanti	ஷரவந்தி
Shrawan	ஷ்ராவன்
Shubelik	ஷூபேலிக்
Shukla	ஷுக்லா
Shun	ஷுன்
Siad	சியாத்
Sidath	சிதாத்
Siddiq	சித்திக்
Sigourney	சிகோர்னி
Sikkey	சிக்கே
Sills	சில்ஸ்
Silverwood	சில்வர்வுட்
Sitaphalmandi	சிதாபால்மாண்டி
Sky	ஸ்கை
Small	ஸ்மால்
Solomon	சாலமன்
Solution	சொல்யூஷன்
Somerset	சோமர்செட்
Sonia	சோனியா
Soolagiri	சூலகிரி
Sosa	சோசா
Soufli	செளஃப்லி
Soya	சோயா
Special	ஸ்பெஷல்
Spielberg	ஸ்பீல்பர்க்
Spinning	ஸ்பின்னிங்
Spion	ஸ்பியான்
Sponge	ஸ்பான்ஜ்
Sriram	ஸ்ரீராம்
Stanovoi	ஸ்டனோவை
States	ஸ்டேட்ஸ்
Steele	ஸ்டீல்
Steels	ஸ்டீல்ஸ்
Stenka	ஸ்டென்கா
Stephens	ஸ்டீபன்ச்
Steurgat	ஸ்டூர்காட்
Strawberry	ஸ்டிராபெர்ரி
Strydom	ஸ்ட்ரைடாம்
Sturt	ஸ்டர்ட்
Styris	ஸ்டிரிஸ்
Su	ஸு
Subramanyam	சுப்ரமணியம்
Sucre	சுக்ரே
Sudirman	சுதிர்மன்
Suhaga	சுஹாகா
Suhaila	சுஹைலா
Suji	சுஜி
Sulagte	சுலாக்தே
Sumerpur	சுமேர்பூர்
Sundaram	சுந்தரம்
Super	சூப்பர்
Suphapong	சுஃபாபோங்
Susana	சூசன்னா
Swann	ஸ்வான்
Swinburne	ஸ்வைன்பர்ன்
Synchronised	சிங்க்ரனைஸ்ட்
Tabish	தபிஷ்
Tahliana	டஹ்லியானா
Tailor	டெய்லர்
Taipei	தைபே
Tanda	தண்டா
Tandy	டாண்டி
Tansco	டான்ஸ்கோ
Tareekh	தாரீக்
Tavare	டாவாரெ
Tavern	டாவர்ன்
Tawanda	டவாண்டா
Teeside	டீசைட்
Telecom	டெலிகாம்
Telegraph	டெலிகிராப்
Terrible	டெரிபிள்
Tessica	டெஸ்ஸிக்கா
Tezuka	டெஸூக்கா
Thanda	டண்டா
The	தே
Theatre	தியேட்டர்
Thelston	தெல்ஸ்டன்
Thermal	தெர்மல்
Thief	தீஃப்
Thilan	திலன்
Thilina	திலினா
Thorn	தார்ன்
Throgs	திராக்ஸ்
Thug	துக்
Ticket	டிக்கெட்
Tidings	டைடிங்ஸ்
Tiger	டைகர்
Tiltman	டில்ட்மேன்
Time	டைப்
Toluca	டோலுகா
Tomlin	டாம்லின்
Torrent	டோரண்ட்
Trading	ட்ரேடிங்
Trikaal	டிரைகால்
Trudeau	ட்ரோடியே
Tsavo	டிசாவோ
Tuffey	டாஃப்பே
Tumhara	துமாரா
Turco	டர்கா
Ueberroth	உபேராத்
Ujesh	உஜேஷ்
Ulster	உல்ஸ்டர்
United	யுனைட்டெட்
Up	அப்
Usha	உஷா
Uthata	உதாடா
Utseya	உத்சேயா
Vallar	வல்லர்
Vaulting	வால்டிங்
Veinticinco	வெய்ன்டிசின்கோ
Velcro	வெல்க்ரோ
Vembakottai	வெம்பகோட்டை
Venetian	வெனெடியன்
Venkatapathy	வெங்கடாபதி
Verizon	வெரிசான்
Vesuvius	வேஸுவியஸ்
Vibhushan	விபூஷன்
Vikalp	விகல்ப்
Vilenica	விலெனிகா
Vivah	விவாஹ்
Vrashabh	விராஷாப்
Vrellis	வ்ரெல்லிஸ்
Wahidul	வஹிதுல்
Wal	வால்
Wala	வாலா
Wallington	வாலிங்டன்
Wanda	வான்டா
Wasim	வாஸிம்
Wax	வாக்ஸ்
Whiting	விட்டிங்
Whitman	விட்மேன்
Whittall	விட்டல்
Whoop	ஹூப்
Wijesuriya	விஜிசூர்யா
Williamson	வில்லியம்சன்
Wishart	விஷார்ட்
Wisneski	விஸ்னெஸ்கி
With	வித்
Woh	வோ
Wolfman	உல்ஃப்மேன்
Woolley	வூலே
Wüttemberg	வுட்டன்பர்க்
Yadon	யாதோன்
Yashodhar	யசோதர்
Yogeendr	யோகீதர்
Zabbar	ஜப்பார்
Zaheer	ஜாஹீர்
Zellweger	ஸெல்வேகர்
Zeppelin	ஸெப்பெலின்
Zindagi	ஸிந்தகி
Zion	ஸியோன்
