Aadhi	ಆದಿ
Aakash	ಆಕಾಶ್
Aap	ಆಪ್
Aayasha	ಆಯಶಾ
Aayee	ಆಯಾ
Abduh	ಅಬ್ದು
Aberhart	ಅಬರಾರ್ಟ್
Abey	ಅಬೆಯ್
Abou	ಅಬು
Abri	ಅಬ್ರಿ
Academy	ಅಕಾಡೆಮಿ
Accommodation	ಅಕಾಮಡೇಶನ್
Acorn	ಅಕಾರ್ನ್
Adams	ಆಡಂಸ್
Adgaon	ಅದಗಾಂವ್
Adlabs	ಆಡ್ಲ್ಯಾಬ್
Agro	ಆಗ್ರೋ
Ahlaad	ಆಹ್ಲಾದ್
Air	ಅಲ್ರ್
Aisin	ಐಸಿನ್
Ajee	ಅಜೀ
Ajhai	ಅಜಹಾಯ್
Ajith	ಅಜಿತ್
Akaram	ಅಕರಮ್
Akele	ಅಕೇಲೆ
Akhri	ಆಖರೀ
Akodia	ಅಕೋಡಿಯಾ
Akurdi	ಅಕುರ್ದಿ
Alas	ಅಲಾಸ್
Albany	ಅಲ್ಬಾನಿ
Alester	ಆಲಿಸ್ಟರ್
Alex	ಅಲೆಕ್ಸ್
Alipur	ಅಲಿಪುರ್
Alkali	ಅಲ್ಕಾಲಿ
Alpesh	ಅಲ್ಪೇಶ್
Amanat	ಅಮಾನತ್
American	ಅಮೆರಿಕ
Amodini	ಅಮೋದಿನಿ
Andha	ಅಂಧಾ
Angel	ಏಂಜೆಲ್
Anna	ಅನ್ನಾ
Anne	ಆನ್
Antibody	ಆಂಟಿಬಾಡಿ
Aon	ಎವೋನ್
Apne	ಅಪ್ನೆ
Araafat	ಅರಾಫತ್
Aries	ಏರಿಸ್
Ark	ಆರ್ಕ್
Arman	ಅರ್ಮಾನ್
Arms	ಆರ್ಮ್ಸ್
Arnott	ಅರ್ನಾಟ್
Arsikere	ಅರಸೀಕೆರೆ
Art	ಆರ್ಟ್
Arthurton	ಆರ್ಥರ್ಟನ್
Ashoka	ಅಶೋಕ
Ashram	ಆಶ್ರಮ್
Asperen	ಆಸ್ಪರೆನ್
Astle	ಆಸ್ಲೆ
Athey	ಅಥೆ
Ati	ಅತಿ
Auckland	ಆಕ್ಲೆಂಡ್
Audaen	ಔದೀನ್
Auliya	ಔಲಿಯಾ
Austro	ಆಸ್ಟ್ರೊ
Aveline	ಅವೆಲಿನ್
Awards	ಅವಾರ್ಡ್ಸ್
Awra	ಆರಾ
Aybak	ಅಯ್ಬಕ್
Ayengi	ಆಯೆಂಗಿ
Baagul	ಬಾಗುಲ್
Baan	ಬಾನ್
Baat	ಬಾತ್
Bada	ಬಡಾ
Bada	ಬಾಡಾ
Badamash	ಬದಮಾಶ್
Bader	ಬೇಡರ್
Badho	ಬಢೋ
Badmashon	ಬದಮಾಶೋಂ
Baghdadi	ಬಗದಾದಿ
Baharwali	ಬಾಹರ್ವಾಲೀ
Balamani	ಬಾಲಮಣಿ
Baldrige	ಬಾಲ್ಡ್ರಿಜ್
Balkham	ಬಲ್ಕ್ಹಾಮ್
Balvant	ಬಲ್ವಂತ್
Bamori	ಬಮೋರಿ
Bandaratilleke	ಬಂಡಾರತಿಲಕೆ
Bandopadyay	ಬಂದೋಪಾಧ್ಯಾಯ್
Banshlai	ಬನ್ಶ್ಲೈ
Baori	ಬಾವುರಿ
Baraigram	ಬಾರೈಗ್ರಾಮ್
Barney	ಬಾರ್ನೀ
Barsao	ಬರಸಾವೋ
Basere	ಬಸೇರೆ
Batti	ಬತ್ತಿ
Batu	ಬಾಟು
Bayazid	ಬಯಾಜಿದ್
Bazar	ಬಾಜಾರ್
Beacon	ಬೇಕನ್
Been	ಬೀನ್
Beethoven	ಬೀದೋವನ್
Begam	ಬೇಗಮ್
Begum	ಬೇಗಮ್
Behram	ಬೆಹರಾಮ್
Bembridge	ಬೆಮ್ಬ್ರಿಡ್ಜ್
Bengal	ಬಂಗಾಲ
Benito	ಬೆನಿಟೋ
Bensonvale	ಬೆನ್ಸೋನ್ವಾಲೆ
Berendrecht	ಬೆರೆನ್ಟ್ರಿಚ್
Beta	ಬೇಟಾ
Bete	ಬೇಟೆ
Bey	ಬೇ
Bha	ಭಾ
Bhabi	ಭಾಭೀ
Bhakt	ಭಕ್ತ್
Bhanjan	ಭಂಜನ್
Bharose	ಭರೋಸೆ
Bharuch	ಭರೂಚ್
Bhatnagar	ಭಟ್ನಾಗರ್
Bhaujai	ಭೌಜಾಯಿ
Bhed	ಭೇದ್
Bhool	ಭೂಲ್
Bhuvaneswari	ಭುವನೇಶ್ವರಿ
Bibhor	ಬಿಭೋರ್
Bijani	ಬಿಜಾನೀ
Bikhare	ಬಿಖರೆ
Bikrom	ಬಿಕ್ರಮ್
Bilhar	ಬಿಲಹರ್
Bill	ಬಿಲ್
Bilson	ಬಿಲ್ಸನ್
Biochem	ಬಯೊಕೆಮ್
Biraj	ಬಿರಜ್
Bisalwas	ಬಿಸಲ್ವಾಸ್
Blackwell	ಬ್ಲಾಕ್ವೆಲ್
Blicks	ಬ್ಲಿಕ್ಸ್
Blignaut	ಬ್ಲಿಗ್ನಾಟ್
Blind	ಬ್ಲೈಂಡ್
Bocher	ಬೂಚರ್
Body	ಬಾಡಿ
Boeta	ಬೊಯೆಟಾ
Boje	ಬೋಯೆ
Boo	ಬೂ
Book	ಬುಕ್
Border	ಬಾರ್ಡರ್
Bosch	ಬೋಶ್
Bowles	ಬೌಲ್ಸ್
Bracewell	ಬ್ರೇಸ್ವೆಲ್
Brahman	ಬ್ರಹಾಮನ್
Brahmanya	ಬ್ರಹ್ಮಣ್ಯ
Breese	ಬ್ರೀಸ್
Breton	ಬ್ರೆಟೊನ್
Brewery	ಬ್ರೀವರಿ
Briant	ಬ್ರಯಾಂಟ್
Bromo	ಬ್ರೋಮೊ
Brooke	ಬ್ರೂಕ್
Bros	ಬ್ರದರ್ಸ್
Brothers	ಬ್ರದರ್ಸ್
Brownlow	ಬ್ರೌನ್ಲೊ
Brunel	ಬ್ರುನೆಲ್
Buckland	ಬಕ್ಲ್ಯಾಂಡ್
Bulfin	ಬಲ್ಫಿನ್
Bureau	ಬ್ಯೂರೊ
Burmah	ಬರ್ಮಾ
Bush	ಬುಷ್
Buy	ಬೈ
Byron	ಬೈರಾನ್
Calgary	ಕಲ್ಗಾರೆ
Campbell	ಕ್ಯಾಂಪಬೆಲ್
Canadas	ಕೆನಡಾಸ್
Capone	ಕೆಪೋನ್
Caring	ಕೇರಿಂಗ್
Carry	ಕ್ಯಾರಿ
Caulfield	ಕಾಲ್ಫೀಲ್ಡ್
Chadar	ಚಾದರ್
Chakaradhari	ಚಕ್ರಧಾರೀ
Champlain	ಚಾಂಪ್ಲೆನ್
Changez	ಚಂಗೆಜ್
Chankanab	ಚಂಕಾನಾಬ್
Chapel	ಚಾಪೆಲ್
Charith	ಚರಿತ್
Chartres	ಚಾರ್ಟೆಸ್
Chartreuse	ಚರ್ಟ್ಯೂಸ್
Chassis	ಚಾಸಿಸ್
Chatfield	ಚಾಟ್ಫೀಲ್ಡ್
Chatterjee	ಚಟರ್ಜಿ
Chatterji	ಚಟರ್ಜಿ
Chaudury	ಜೌಧರಿ
Chaylse	ಚೆಲ್ಸೀ
Cheer	ಚೀರ್
Chemical	ಕೆಮಿಕಲ್
Chennakesava	ಚೆನ್ನಕೇಶವ
Chhoo	ಛೂ
Chilbila	ಚಿಲ್ಬಿಲಾ
Chipewyan	ಚಿಪ್ವೆನ್
Chirstian	ಕ್ರಿಶ್ಚಿಯನ್
Choice	ಚಾಯ್ಸ್
Cholvaram	ಚೋಲಾವರಂ
Choron	ಚೋರೋಂ
Chorvad	ಚೋರ್ವದ್
Chronicle	ಕ್ರಾನಿಕಲ್
Churchill	ಚರ್ಚಿಲ್
Chyulu	ಚುಯುಲು
Cidades	ಸಿಡಾಡೆಸ್
Cimatario	ಸಿಮಾಟಾರಿಯೊ
Citadel	ಸಿಟಾಡೆಲ್
Coat	ಕೋಟ್
Coca	ಕೋಕಾ
Coffee	ಕಾಫಿ
Cola	ಕೋಲಾ
Colour	ಕಲರ್
Commandante	ಕಮಾಂಡೆಂಟ್
Computers	ಕಂಪ್ಯೂಟರ್ಸ್
Condecoracion	ಕಾಂಡೆಕೊರಾಕಿಯನ್
Condoleeza	ಕಾಂಡೋಲೀನಾ
Consolidated	ಕನ್ಸಾಲಿಡೇಟೆಡ್
Coolagh	ಕೂಲಾಗ್
Copco	ಕೋಪ್ಕೋ
Corazon	ಕೋರೆಜೋನ್
Cosier	ಕೋಸಿಯರ್
Count	ಕೌಂಟ್
Cref	ಕ್ರೆಫ್
Cronje	ಕ್ರೋನಿಯೆ
Crookhorn	ಕ್ರಾಕ್ಹಾರ್ನ್
Crossing	ಕ್ರಾಸಿಂಗ್
Crown	ಕ್ರೌನ್
Culture	ಕಲ್ಚರ್
Curtly	ಕರ್ಟ್ಲಿ
Cyber	ಸೈಬರ್
Daal	ದಾಲ್
Dabhoi	ದಾಭೋಯ್
Dabli	ದಾಬಲೀ
Daegu	ಡೇಗು
Daghfal	ದಗ್ಫಲ್
Daghfal	ದಗ್‌ಫಲ್
Dahade	ದಹಾಡೆ
Dahesh	ದಹೇಶ್
Dai	ದೈ
Dalrymple	ಡಾರ್ಲಿಂಪಲ್
Damdama	ದಂದಮಾ
Dannie	ಡ್ಯಾನಿ
Dapeng	ದಾಪೆಂಗ್
Daryl	ಡೆರಿಲ್
Daur	ದೌರ್
David	ಡೇವಿಡ್
Davies	ಡೇವಿಯಸ್
Day	ಡೇ
Dead	ಡೆಡ್
Decembre	ಡಿಸೆಂಬ್ರೆ
Deewane	ದೀವಾನೆ
Deirdre	ಡೀಡ್ರಿ
Deke	ದೇಕೆ
Dekh	ದೇಖ್
Dena	ದೇನಾ
Denzel	ಡೆಂಜಲ್
Depot	ಡಿಪೋ
Deryck	ಡೆರಿಕ್
Des	ದೇಸ್
Desoto	ಡೆಸೊಟೊ
Devdas	ದೇವದಾಸ್
Dhahir	ಧಾಹಿರ್
Dhalaibil	ಧಲೈಬಿಲ್
Dhari	ಧಾರೀ
Dhobari	ಧೊಬರಿ
Diamond	ಡೈಮಂಡ್
Dibosh	ಡಿಬೋಶ್
Dickman	ಡಿಕ್ಮ್ಯಾನ್
Dike	ಡೈಕ್
Dilhara	ದಿಲ್ಹಾರಾ
Dilwale	ದಿಲ್ವಾಲೆ
Dina	ದಿನಾ
Dior	ಡಯರ್
Diplomatic	ಡಿಪ್ಲೊಮೆಟಿಕ್
Disabled	ಡಿಸೇಬಲ್ಡ್
Disk	ಡಿಸ್ಕ್
Disney	ಡಿಸ್ನಿ
Dlink	ಡಿಲಿಂಕ್
Dodi	ಡೋಡಿ
Doll	ಡಾಲ್
Dongargarh	ದೊಂಗರ್ಗಢ್
Dongargarh	ದೊಂಗರ್‌ಗಢ್
Donnanview	ಡೋನಾನ್ವೀವ್
Dono	ದೋನೋ
Doolha	ದುಲ್ಹಾ
Drama	ಡ್ರಾಮಾ
Dravid	ದ್ರಾವಿಡ್
Drawing	ಡ್ರಾಯಿಂಗ್
Dripping	ಡ್ರಿಪ್ಪಿಂಗ್
Drive	ಡ್ರೈವ್
Drucilla	ಡ್ರುಸಿಲ್ಲಾ
Dukakis	ಡ್ಯೂಕಾಕಿಸ್
Dulip	ದುಲಿಪ್
Dwarikesh	ದ್ವಾರಕೀಶ್
Dymock	ಡೈಮಾಕ್
Eddo	ಎಡ್ಡೋ
Edger	ಎಡ್ಗರ್
Edmonds	ಎಡ್ಮಂಡ್ಸ್
Egmore	ಎಗ್ಮೋರ್
Egyptian	ಇಜಿಪ್ಟಿಯನ್
Einstein	ಐನ್ಸ್ಟೀನ್
Elbit	ಎಲ್ಬಿಟ್
Elder	ಎಲ್ಡರ್
Elders	ಎಲ್ಡರ್ಸ್
Ellan	ಎಲಾನ್
Elmer	ಎಲ್ಮರ್
Elong	ಇಲಾಂಗ್
Emburey	ಎಂಬುರೆ
Enterprises	ಎಂಟರ್ಪ್ರೈಸಸ್
Erhard	ಎರಾರ್ಡ್
Eric	ಎರಿಕ್
Ervine	ಇರ್ವಿನ್
Erwin	ಇರ್ವಿನ್
Erzherzog	ಎಜರ್ಜೋಗ್
Estonian	ಇಸ್ಟೊನಿಯನ್
Estrella	ಎಸ್ಟ್ರೆಲ್ಲಾ
Etemad	ಇತ್ತೆಮಾದ್
Eugenia	ಯುಜೇನಿಯಾ
Explor	ಎಕ್ಸ್ಪ್ಲೋರ್
Eyed	ಐಡ್
Fantasy	ಫಾಂಟಸಿ
Fargo	ಫಾರ್ಗೋ
Fasteners	ಫಾಸ್ಟೆನರ್ಸ್
Fazal	ಫಜಲ್
Fazl	ಫಸಲ್
Fernado	ಫೆರ್ನೆಡೊ
Ferrero	ಫೆರೇರೋ
Ferro	ಫೆರೊ
Fond	ಫಾಂಡ್
Fredricka	ಫ್ರೆಡ್ರಿಕಾ
Frissiras	ಫ್ರಿಸಿರಸ್
Frontier	ಫ್ರಂಟಿಯರ್
Gadag	ಗದಗ್
Gadra	ಗಾದರಾ
Galaxidi	ಗೆಲ್ಯಾಕ್ಸಿಡಿ
Galileo	ಗೆಲಿಲಿಯೊ
Gallants	ಗ್ಯಾಲೆಂಟ್ಸ್
Gambhiri	ಗಂಭೀರೀ
Ganagapur	ಗಂಗಾಪುರ್
Ganegama	ಗನೆಗಮಾ
Garam	ಗರಮ್
Garm	ಗರಮ್
Garner	ಗಾರ್ನರ್
Gauss	ಗಾಸ್
Gautama	ಗೌತಮ
Gauvin	ಗೋವಿನ್
Geraldene	ಗೆರಾಲ್ಡಿನ್
Gerita	ಗೆರಿತಾ
Germanium	ಜೆರ್ಮನಿಯಂ
Ghanvatkar	ಘನವಟಕರ್
Ghazali	ಗಜಾಲಿ
Ghoda	ಘೋಡಾ
Ghorakhal	ಘೋರಖಲ್
Ghule	ಘುಲೆ
Gifford	ಗಿಫರ್ಡ್
Gladys	ಗ್ಲೇಡಿಸ್
Glamorgan	ಗ್ಲಾಮರ್ಗನ್
Globe	ಗ್ಲೋಬ್
Gokhale	ಗೋಖಲೆ
Gokte	ಗೊಕ್ಟೆ
Gombe	ಗೋಂಬೆ
Goncourt	ಗಾನ್ಕೋರ್ಟ್
Gorshkov	ಗೋರ್ಷ್ಕೋವ್
Gossaigaon	ಗೊಸೈಗಂಜ್
Goswami	ಗೋಸ್ವಾಮಿ
Govindnagar	ಗೋವಿಂದನಗರ್
Graf	ಗ್ರಾಫ್
Gray	ಗ್ರೇ
Grentech	ಗ್ರೆನ್ಟೆಕ್
Greville	ಗ್ರೆವಿಲ್ಲಿ
Gross	ಗ್ರಾಸ್
Gudha	ಗುಧಾ
Gujarat	ಗುಜರಾತ್
Gulabi	ಗುಲಾಬೀ
Gulf	ಗಲ್ಫ್
Gunderippalam	ಗುಂಡೇರಿಪಲ್ಲಮ್
Gvk	ಜಿವಿಕೆ
Haamid	ಹಾಮಿದ್
Hafeez	ಹಫೀಜ್
Haley	ಹೆಲೇ
Half	ಹಾಫ್
Hamamah	ಹಮಮಾ
Hanste	ಹಂಸ್ತೇ
Hara	ಹಾರಾ
Harsingar	ಹರಸಿಂಗಾರ್
Harvey	ಹಾರ್ವೇ
Harwich	ಹಾರ್ವಿಕ್
Hatao	ಹಟಾವೋ
Hayy	ಹಯ್
Heeron	ಹೀರೋಂ
Hells	ಹೆಲ್ಸ್
Hemmings	ಹೆಮಿಂಗ್ಸ್
Higher	ಹೈಯರ್
Hilfiger	ಹಿಲ್ಫಿಗರ್
Hill	ಹಿಲ್
Hillcrest	ಹಿಲ್ಕ್ರೆಸ್ಟ್
Hindustan	ಹಿಂದೂಸ್ತಾನ್
Hisaab	ಹಿಸಾಬ್
Hiyo	ಹಿಯೊ
Hogg	ಹಾಗ್
Holder	ಹೋಲ್ಡರ್
Hole	ಹೋಲ್
Holiday	ಹಾಲಿಡೇ
Homestead	ಹೋಮ್ಸ್ಟೆಡ್
Honda	ಹೋಂಡಾ
Hone	ಹೋನೆ
Hoon	ಹೂಂ
Hosanna	ಹೊಸಾನಾ
Hub	ಹಬ್
Huddersfield	ಹಡರ್ಸ್ಫೀಲ್ಡ್
Hugli	ಹೂಗ್ಲಿ
Hull	ಹಲ್
Humari	ಹಮಾರೀ
Humpage	ಹಂಪೇಜ್
Hunaydah	ಹುನೇದಾ
Hundred	ಹಂಡ್ರೆಡ್
Hunt	ಹಂಟ್
Husn	ಹುಸ್ನ್
Hydrogenics	ಹೈಡ್ರೋಜೆನಿಕ್ಸ್
Ibadat	ಇಬಾದತ್
Icahn	ಇಚಾನ್
Igglesden	ಇಗ್ಲೆಸ್ಡನ್
Image	ಇಮೇಜ್
Inam	ಇನಾಮ್
Indukaant	ಇಂದುಕಾಂತ್
Ingersoll	ಇಂಗರ್ಸೋಲ್
Insaf	ಇನ್ಸಾಫ್
Instruction	ಇನ್ಸ್ಟ್ರಕ್ಷನ್
Intercontinental	ಇಂಟರ್ಕಾಂಟಿನೆಂಟಲ್
International	ಇಂಟರ್ನ್ಯಾಶನಲ್
Irishmen	ಐರಿಶ್ಮೆನ್
Isle	ಇಸ್ಲೇ
Istvan	ಇಸ್ತ್ವಾನ್
Italiano	ಇಟಾಲಿಯಾನೊ
Itawa	ಇಟಾವಾ
Iventure	ಇವೆಂಚರ್
Jaafaree	ಜಾಫರೀ
Jaani	ಜಾನಿ
Jaarsveld	ಜಾರ್ಸ್ವೆಲ್ಡ್
Jacob	ಜಾಕೊಬ್
Jahrousse	ಜಾರೌಸೀ
Jaise	ಜೈಸೆ
Jaitu	ಜೈತು
Jalti	ಜಲತೀ
Jamai	ಜಮಾಯಿ
Jamda	ಜಮದಾ
Janasadharan	ಜನಸಾಧಾರಣ್
Janjgir	ಜಾಂಜ್ಗಿರ್
Javagal	ಜಾವಗಲ್
Jayanagar	ಜಯನಗರ
Jayantha	ಜಯಂತ
Jayaprakashdaran	ಜಯಪ್ರಕಾಶದರನ್
Jecy	ಜೇಸಿ
Jeeo	ಜೀಯೊ
Jeeta	ಜೀತಾ
Jet	ಜೆಟ್
Jewish	ಜ್ಯುವಿಶ್
Jhuk	ಜುಕ್
Jhukenge	ಝುಕೇಂಗೆ
Jhukta	ಜುಕ್ತಾ
Jilani	ಜಿಲಾನಿ
Jim	ಜಿಮ್
Jin	ಜೈ
Jo	ಜೋ
Jodhpuri	ಜೋಧ್ಪುರಿ
Jodhpuri	ಜೋಧ್‌ಪುರಿ
Johan	ಜೋಹಾನ್
Judge	ಜಡ್ಜ್
Jwar	ಜ್ವಾರ್
Jyotiba	ಜ್ಯೋತಿಬಾ
Jyotirlinga	ಜ್ಯೋತಿರ್ಲಿಂಗ
Kaala	ಕಾಲಾ
Kaamil	ಕಾಮಿಲ್
Kaashi	ಕಾಶಿ
Kab	ಕಬ್
Kabira	ಕಬೀರಾ
Kajaria	ಕಜಾರಿಯಾ
Kalpage	ಕಲ್ಪಗೆ
Kambli	ಕಾಂಬ್ಳಿ
Kanaklata	ಕನಕಲತಾ
Kandamby	ಕಂದಾಂಬಿ
Kandaswamy	ಕಂದಸ್ವಾಮಿ
Kandh	ಖಂಡ್
Kanengara	ಕನೆಂಗರ
Kaneria	ಕನೇರಿಯಾ
Kanhaiya	ಕನಹೈಯಾ
Kanhaiya	ಕನೈಯಾ
Kanhaiya	ಕನ್‌ಹೈಯಾ
Kante	ಕಾಂಟೆ
Kanya	ಕನ್ಯಾ
Karamah	ಕರಮಾ
Karanjwan	ಕರನ್ಜ್ವಾನ್
Karega	ಕರೇಗಾ
Karl	ಕಾರ್ಲ್
Karoonga	ಕರೂಂಗಾ
Karwa	ಕರವಾ
Kasturi	ಕಸ್ತೂರಿ
Katilon	ಕಾತಿಲೋಂ
Katse	ಕಾಟ್ಸೆ
Kawachi	ಕವಾಚಿ
Kazim	ಕಾಜಿಂ
Keats	ಕೀಟ್ಸ್
Kenedy	ಕೆನೆಡಿ
Kennedy	ಕೆನಡಿ
Kenosha	ಕೆನೋಶಾ
Kerr	ಕೆರ್
Kettle	ಕೆಟಲ್
Ketu	ಕೇತು
Khaled	ಖಾಲೆದ್
Khana	ಖಾನಾ
Khayriyah	ಖೇರಿಯಾ
Khayyam	ಖಯ್ಯಾಮಿ
Khelte	ಖೇಲ್ತೇ
Khoda	ಖೋಡಾ
Khooni	ಖೂನೀ
Khufia	ಖುಫಿಯಾ
Kijkuit	ಕಿಜ್ಕುಟ್
Killarney	ಕಿಲಾರ್ನೆ
Kirmani	ಕೀರ್ಮಾನಿ
Kis	ಕಿಸ್
Kise	ಕಿಸೀ
Kisi	ಕಿಸೀ
Kissa	ಕಿಸ್ಸಾ
Kitne	ಕಿತನೆ
Klusener	ಕ್ಲೂಸ್ನರ್
Kol	ಕೊಲ್
Kon	ಕೊನ್
Korene	ಕೋರಿನ್
Kosan	ಕೋಸನ್
Koto	ಕೋಟೋ
Krebs	ಕ್ರೆಬ್ಸ್
Kris	ಕ್ರಿಸ್
Kulasekara	ಕುಲಶೇಖರ
Kutte	ಕುತ್ತೇ
Kyonji	ಕ್ಯೂಜಿ
Lac	ಲ್ಯಾಕ್
Lajwati	ಲಾಜವಾತಿ
Lakshmipathy	ಲಕ್ಷ್ಮಿಪತಿ
Lal	ಲಾಲ್
Land	ಲ್ಯಾಂಡ್
Lanen	ಲೇನೆನ್
Las	ಲಾಸ್
Lasker	ಲಾಸ್ಕರ್
Layegi	ಲಾಯೆಗೀ
Lehmann	ಲೆಹಮನ್
Lei	ಲೇ
Lenge	ಲೇಂಗೆ
Letters	ಲೆಟರ್ಸ್
Lever	ಲೀವರ್
Leyland	ಲೀಲ್ಯಾಂಡ್
Light	ಲೈಟ್
Lindy	ಲಿಂಡಿ
Lisa	ಲೀಸಾ
Lobachevsky	ಲೊಬಾಚೆವಸ್ಕಿ
Loha	ಲೋಹಾ
Lok	ಲೋಕ್
Loydchiles	ಲಾಯ್ಡ್ಚಿಲೀಸ್
Lucky	ಲಕೀ
Luitpold	ಲೂಯಿಟ್ಪೋಲ್ಡ್
Luther	ಲೂಥರ್
Lynn	ಲಿನ್
Lytton	ಲಾಯ್ಟನ್
Maahir	ಮಾಹಿರ್
Maange	ಮಾಂಗೆ
Maar	ಮಾರ್
Macewen	ಮೆಕೆವೆನ್
Mackay	ಮೆಕೇ
Mad	ಮದ್
Madari	ಮದರಿ
Madine	ಮದೀದೆ
Magna	ಮ್ಯಾಗ್ನಾ
Mah	ಮಹಾರಾಷ್ಟ್ರ
Mahajabeen	ಮಹಾಜಬೀನ್
Mahapatra	ಮಹಾಪಾತ್ರ
Mahommed	ಮಹಮೂದ್
Mail	ಮೈಲ್
Mal	ಮಲ್
Malka	ಮಲ್ಕಾ
Maluku	ಮಲುಕು
Mamta	ಮಮತಾ
Manikpur	ಮನಿಕ್ಪುರ್
Manjural	ಮಂಜುರಲ್
Mannar	ಮನ್ನಾರ್
Mansoor	ಮನ್ಸೂರ್
Marcantonio	ಮಾರ್ಕೆಂಟೋನಿಯೊ
Marchais	ಮಾರ್ಕೆಸ್
Marie	ಮೆರೀ
Marjina	ಮರ್ಜೀನಾ
Marudhanadhi	ಮರುಧಾನಧಿ
Masjid	ಮಸ್ಜಿದ್
Mason	ಮಾಸನ್
Matav	ಮಾಟವ್
Mathew	ಮ್ಯಾಥ್ಯೂ
Matt	ಮಟ್
Mattis	ಮಾಟಿಸ್
Maunsell	ಮೌಸೆಲ್
Mawenge	ಮಾವೆಂಗ್
Mawlana	ಮಾವ್ಲಾನಾ
Mcclary	ಮ್ಯಾಕ್ಕ್ಲಾರಿ
Meda	ಮೆಡಾ
Meghdoot	ಮೇಘದೂತ್
Meher	ಮೆಹರ್
Mehrab	ಮಹ್ರಬ್
Mei	ಮೆ
Melleha	ಮೆಲ್ಲೆಹಾ
Memorial	ಮೆಮೊರಿಯಲ್
Menara	ಮೆನಾರಾ
Mengkuang	ಮೆಂಗಕುವಾಂಗ್
Mera	ಮೆರಾ
Mere	ಮೆರೆ
Merit	ಮೆರಿಟ್
Merrill	ಮೆರಿಲ್
Metal	ಮೆಟಲ್
Meth	ಮೇಥ್
Methuselah	ಮೆತುಸೆಲಾ
Mexican	ಮೆಕ್ಸಿಕನ್
Meyrick	ಮೆರಿಕ್
Mhale	ಮ್ಹಾಲೆ
Michener	ಮಿಕೆನರ್
Micholi	ಮಿಚೌಲೀ
Middleton	ಮಿಡ್ಲ್ಟನ್
Milai	ಮಿಲಾಯಿ
Minto	ಮಿಂಟೋ
Mitcham	ಮಿಚಾಮ್
Mitenge	ಮಿಟೇಂಗೆ
Mitsubishi	ಮಿತ್ಸುಬಿಷಿ
Moinuddin	ಮೊಯ್ನುದ್ದೀನ್
Monsanto	ಮಾನ್ಸೆಂಟೊ
Montshire	ಮಾಂಟ್ಶೈರ್
Morosini	ಮೊರೊಸಿನಿ
Morro	ಮೊರೋ
Moultrie	ಮೌಲ್ಟ್ರಿ
Mouth	ಮೌತ್
Mozart	ಮೋಜಾರ್ಟ್
Mrinali	ಮೃಣಾಲಿ
Mujeeb	ಮುಜೀಬ್
Mulhouse	ಮುಲ್ಹೌಸ್
Multi	ಮಲ್ಟಿ
Muneem	ಮುನೀಂ
Munsif	ಮುನ್ಸಿಫ್
Muralitharan	ಮುರಳೀಧರನ್
Murdoch	ಮುರ್ಡೋಕ್
Mushfiqur	ಮುಷ್ಫಿಕರ್
Mutahharah	ಮುತಾಹ್ಹರಾ
My	ಮೈ
Naami	ನಾಮಿ
Naate	ನಾತೆ
Nagamootoo	ನಂಗಮೂಟೂ
Nahin	ನಹೀ
Nakhimov	ನಾಖಿಮೊವ್
Nansen	ನಾನ್ಸೇನ್
Nascopie	ನ್ಯಾಸ್ಕೋಪಿ
Nasheen	ನಶೀನ್
Nawaz	ನವಾಜ್
Naya	ನಹಾ
Nazar	ನಜರ್
Neeli	ನೀಲೀ
Neera	ನೀರಾ
Netravati	ನೇತ್ರಾವತಿ
Night	ನೈಟ್
Nightingale	ನೈಟಿಂಗೇಲ್
Nikita	ನಿಕಿತಾ
Nimrod	ನಿಮ್ರೊಡ್
Nimrod	ನಿಮ್‌ರೋಡ್
Nirdoshi	ನಿರ್ದೋಶೀ
Nishchay	ನಿಶ್ಚಯ್
Nolte	ನೋಲ್ಟೇ
Noord	ನೂರ್ದ್
Northern	ನಾರ್ದರ್ನ್
Northumbria	ನಾರ್ತಂಬ್ರಿಯಾ
Nottingham	ನಾಟಿಂಗ್ಹ್ಯಾಮ್
Novamerican	ನೋವಾಮೆರಿಕನ್
Oldonyo	ಆಲ್ಡೋನ್ಯೋ
Oonch	ಊಂಚ್
Or	ಆರ್
Orly	ಓರ್ಲಿ
Ormula	ಆರ್ಮುಲಾ
Osamu	ಒಸಾಮು
Overland	ಓವರ್ಲ್ಯಾಂಡ್
Paandu	ಪಾಂಡು
Painter	ಪೈಂಟರ್
Palanca	ಪಲಾಂಕಾ
Palung	ಪಲುಂಗ್
Panama	ಪನಾಮಾ
Pantanal	ಪಂಟಾನಲ್
Papps	ಪಾಪ್ಸ್
Par	ಪರ್
Parcel	ಪಾರ್ಸೆಲ್
Parineeta	ಪರಿಣಿತಾ
Parkar	ಪಾರ್ಕರ್
Parks	ಪಾರ್ಕ್ಸ್
Parthiv	ಪಾರ್ಥಿವ್
Parvat	ಪರ್ವತ್
Pascoal	ಪ್ಯಾಸ್ಕೋಲ್
Pasina	ಪಸೀನಾ
Pasqual	ಪಾಸ್ಕಲ್
Patnee	ಪತ್ನಿ
Patton	ಪ್ಯಾಟಾನ್
Pauls	ಪಾಲ್ಸ್
Pavarotti	ಪಾವಾರೋಟೀ
Paying	ಪೇಯಿಂಗ್
Payod	ಪಯೋದ್
Peach	ಪಿಚ್
Pearsall	ಪಿಯರ್ಸಲ್
Pearson	ಪಿಯರ್ಸನ್
Pentamedia	ಪೆಂಟಾಮೀಡಿಯಾ
Peoples	ಪೀಪಲ್ಸ್
Person	ಪರ್ಸನ್
Peters	ಪೀಟರ್ಸ್
Peterson	ಪೀಟರ್ಸನ್
Philo	ಫಿಲೋ
Phoolvati	ಪೂಲ್ವತಿ
Photo	ಫೋಟೋ
Photography	ಫೋಟೊಗ್ರಫಿ
Pick	ಪಿಕ್
Picnic	ಪಿಕ್ನಿಕ್
Picnic	ಪಿಕ್‌ನಿಕ್
Piet	ಪೀಟ್
Place	ಪ್ಲೇಸ್
Plate	ಪ್ಲೇಟ್
Pollock	ಪೋಲಕ್
Polydex	ಪಾಲಿಡೆಕ್ಸ್
Pontiacs	ಪಾಂಟಕ್ಸ್
Pontisse	ಪೊಂಟಿಸಿ
Poori	ಪುರಿ
Pope	ಪೋಪ್
Portela	ಪೋರ್ಟೆಲಾ
Poste	ಪೋಸ್ಟೆ
Prabhati	ಪ್ರಭಾತಿ
Prachur	ಪ್ರಚುರ್
Pramodya	ಪ್ರಮೋದಯ
Pregl	ಪ್ರೆಗ್ಲ್
Premio	ಪ್ರೆಮಿಯೊ
Presernova	ಪ್ರೆಸರ್ನೋವಾ
Press	ಪ್ರೆಸ್
Priest	ಪ್ರೀಸ್ಟ್
Print	ಪ್ರಿಂಟ್
Professional	ಪ್ರೊಫೆಶನಲ್
Profiles	ಪ್ರೊಫೈಲ್ಸ್
Provincien	ಪ್ರೋವಿನ್ಸಿಯನ್
Pruth	ಪ್ರಥ
Publix	ಪಬ್ಲಿಕ್ಸ್
Pucca	ಪಕ್ಕಾ
Pukarega	ಪುಕಾರೇಗಾ
Punja	ಪಂಜಾ
Purab	ಪೂರಬ್
Purani	ಪುರಾನಾ
Puroskar	ಪುರೊಸ್ಕಾರ್
Purvoday	ಪೂರ್ವೋದಯ್
Purza	ಪುರ್ಜಾ
Pyare	ಪ್ಯಾರೆ
Qin	ಕಿನ್
Quad	ಕ್ವಾಡ್
Quality	ಕ್ವಾಲಿಟಿ
Quanoon	ಕ್ವಾನೂನ್
Quarban	ಕುರ್ಬಾನ್
Quila	ಕಿಲಾ
Rada	ರಾಡಾ
Ragoonath	ರಘುನಾಥ್
Rahmah	ರಹಮಾಹ್
Raho	ರಹೋ
Rahu	ರಾಹು
Rain	ರೈನ್
Raina	ರಾಯನ್
Rajesh	ರಾಜೇಶ್
Rajhara	ರಾಜಹಾರಾ
Rakhra	ರಾಖರಾ
Ramco	ರಾಮ್ಕೊ
Ramdin	ರಾಮ್ದಿನ್
Ranchi	ರಾಂಚಿ
Rangeeli	ರಂಗೀಲೀ
Rangeen	ರಂಗೀನ್
Rangile	ರಂಗೀಲೆ
Raqibul	ರಖಿಬುಲ್
Rashk	ರಶ್ಕ್
Rastriya	ರಾಷ್ಟ್ರೀಯ
Reddys	ರೆಡ್ಡಿ
Refin	ರಿಫೈನರಿ
Rennie	ರೆನ್ನೀ
Research	ರಿಸರ್ಚ್
Right	ರೈಟ್
Rim	ರಿಮ್
Ripper	ರಿಪ್ಪರ್
Ritchie	ರಿಚಿ
Robinhood	ರಾಬಿನ್ಹುಡ್
Ronduit	ರಾಂಡ್ಯೂಟ್
Roopaa	ರೂಪಾ
Rootha	ರೂಥಾ
Ruka	ರುಕಾ
Rush	ರಶ್
Ruth	ರುಥ್
Ruzyne	ರುಜೈನ್
Ryan	ರಾಯನ್
Ryanair	ರಾಯನೇರ್
Ryder	ರೈಡರ್
S	ಎಸ್
Saab	ಸಾಬ್
Sachai	ಸಚ್ಚಾಯಿ
Sadashiv	ಸದಾಶಿವ
Sadeem	ಸದೀಮ್
Sadhana	ಸಾಧನಾ
Sadra	ಸದರಾ
Safiyyah	ಸೇಫಿಯಾ
Saful	ಸಫುಲ್
Said	ಸೈದ್
Saiful	ಸೈಫುಲ್
Saigal	ಸೈಗಲ್
Sainte	ಸೆಂಟ್
Saleh	ಸಾಲೇ
Sama	ಸಮಾ
Sammy	ಸಾಮೀ
Sanawbar	ಸನಾವ್ವರ್
Sanitary	ಸ್ಯಾನಿಟರಿ
Sanket	ಸಂಕೇತ್
Sap	ಎಸ್ಎಪಿ
Sapera	ಸಪೇರಾ
Sapera	ಸಪೆರಾ
Sariyah	ಸರೀಯಾ
Sarovar	ಸರೋವರ್
Satta	ಸಟ್ಟಾ
Sattaar	ಸತ್ತಾರ್
Satte	ಸತ್ತೆ
Savu	ಸಾವು
Sawar	ಸವಾರ್
Saymukta	ಸಂಯುಕ್ತ
Schuyler	ಸ್ಕ್ಯೂಲರ್
Scissor	ಸಿಸರ್
Scorpio	ಸ್ಕಾರ್ಪಿಯೊ
Scottish	ಸ್ಕಾಟಿಷ್
Sebastien	ಸೆಬಾಸ್ಟಿಯನ್
Seblat	ಸೆಬ್ಲಟ್
Secunderabad	ಸಿಕೆಂದರಾಬಾದ್
Seedha	ಸೀಧಾ
Seekh	ಸೀಖ್
Sei	ಸೆಯಿ
Seiki	ಸೈಕಿ
Seinfeld	ಸೇನ್ಫೆಲ್ಡ್
Selleck	ಸೆಲೆಕ್
Senior	ಸೀನಿಯರ್
Serjeant	ಸರ್ಜೀಯಂಟ್
Seth	ಸೇಠ್
Shaanxi	ಶಾಂಕ್ಸಿ
Shahdara	ಶಾಹದರಾ
Shakespeare	ಶೇಕ್ಸ್ಪಿಯರ್
Sham	ಶಾಮ್
Shamshera	ಶರಶೇರಾ
Shanda	ಶಾಂಡಾ
Shani	ಶನಿ
Shatrujay	ಶತ್ರುಜಯ್
Shaukat	ಶೌಕತ್
Shaul	ಶಾಲ್
Sheehy	ಶೀಹಿ
Sheetla	ಶೀತಲಾ
Sheikh	ಶೇಕ್
Shek	ಶೆಕ್
Sheridan	ಶೆರಿಡಿಯನ್
Sherwin	ಶೆರ್ವಿನ್
Shillingford	ಶಿಲಿಂಗ್ಫರ್ಡ್
Shivaji	ಶಿವಾಜಿ
Shivam	ಶಿವಂ
Shokh	ಶೋಖ್
Shravanti	ಶ್ರವಂತಿ
Shrawan	ಶ್ರವಣ
Shubelik	ಶುಬೇಲಿಕ್
Shukla	ಶುಕ್ಲಾ
Shun	ಶುಲ್
Siad	ಸಿಯಾಡ್
Sidath	ಸಿದಾತ್
Siddiq	ಸಿದ್ದಿಕ್
Sigourney	ಸಿಗೋರ್ನೀ
Sikkey	ಸಿಕ್ಕೆ
Sills	ಸಿಲ್ಸ್
Silverwood	ಸಿಲ್ವರ್ವುಡ್
Sitaphalmandi	ಸೀತಾಫಲಮಂಡಿ
Sky	ಸ್ಕೈ
Small	ಸ್ಮಾಲ್
Solomon	ಸೋಲೋಮನ್
Solution	ಸಲ್ಯೂಷನ್ಸ್
Somerset	ಸೋಮರ್ಸೆಟ್
Sonia	ಸೋನಿಯಾ
Soolagiri	ಸೋಲಾಗಿರಿ
Sosa	ಸೋಸಾ
Soufli	ಸುಫ್ಲಿ
Soya	ಸೋಯಾ
Special	ಸ್ಪೆಶಲ್
Spielberg	ಸ್ಪೀಲ್ಬರ್ಗ್
Spinning	ಸ್ಪಿನ್ನಿಂಗ್
Spion	ಸ್ಪಿಯನ್
Sponge	ಸ್ಪಾನ್ಜ್
Sriram	ಶ್ರೀರಾಮ್
Stanovoi	ಸ್ಟನೊವೋ
States	ಸ್ಟೇಟ್ಸ್
Steele	ಸ್ಟೀಲೆ
Steels	ಸ್ಟ್ರೀಲ್ಸ್
Stenka	ಸ್ಟೆಂಕಾ
Stephens	ಸ್ಟೀಫನ್ಸ್
Steurgat	ಸ್ಟ್ಯೂಗ್ರಟ್
Strawberry	ಸ್ಟ್ರಾಬೆರ್ರಿ
Strydom	ಸ್ಟ್ರೈಡಂ
Sturt	ಸ್ಟರ್ಟ್
Styris	ಸ್ಟೈರಿಸ್
Su	ಸೂ
Subramanyam	ಸುಬ್ರಮಣ್ಯಂ
Sucre	ಸುಕ್ರ್
Sudirman	ಸುದಿರ್ಮನ್
Suhaga	ಸುಹಾಗಾ
Suhaila	ಸಹೈಲಾ
Suji	ಸುಜಿ
Sulagte	ಸುಲಗತೆ
Sumerpur	ಸುಮೇರ್ಪುರ್
Sundaram	ಸುಂದರಂ
Super	ಸೂಪರ್
Suphapong	ಸುಫಾಪೋಂಗ್
Susana	ಸುಸಾನಾ
Swann	ಸ್ವಾನ್
Swinburne	ಸ್ವಿಂಬರ್ನ್
Synchronised	ಸಿಂಕ್ರನೈಸ್ಡ್
Tabish	ತಬಿಶ್
Tahliana	ತಹಲೀಯಾನಾ
Tailor	ಟೇಲರ್
Taipei	ತೈಪೆ
Tanda	ಟಾಂಡಾ
Tandy	ಟ್ಯಾಂಡಿ
Tansco	ಟಾನ್ಸ್ಕೋ
Tareekh	ತಾರೀಖ್
Tavare	ತವರೆ
Tavern	ಟವರ್ನ್
Tawanda	ತವಾಂಡ
Teeside	ಟೀಸೈಡ್
Telecom	ಟೆಲಿಕಾಮ್
Telegraph	ಟೆಲಿಗ್ರಾಫ್
Terrible	ಟೆರಿಬಲ್
Tessica	ಟೆಸ್ಸಿಕಾ
Tezuka	ತೆಜುಕಾ
Thanda	ಥಂಡಾ
The	ಥೆ
Theatre	ಥಿಯೇಟರ್
Thelston	ತೆಲ್ಸ್ಟನ್
Thermal	ಥರ್ಮಲ್
Thief	ಥೀಫ್
Thilan	ತಿಲನ್
Thilina	ತಿಲಿನಾ
Thorn	ಥಾರ್ನ್
Throgs	ಥ್ರಾಗ್ಸ್
Thug	ಠಗ್
Ticket	ಟಿಕೆಟ್
Tidings	ಟೈಡಿಂಗ್ಸ್
Tiger	ಟೈಗರ್
Tiltman	ಟಿಲ್ಟ್ಮ್ಯಾನ್
Time	ಟೈಮ್
Toluca	ಟೊಲುಕಾ
Tomlin	ಟಾಮ್ಲಿನ್
Torrent	ಟಾರೆನ್ಟ್
Trading	ಟ್ರೇಡಿಂಗ್
Trikaal	ತ್ರಿಕಾಲ್
Trudeau	ಟ್ರೂಟ್ಯೂ
Tsavo	ಸಾವೋ
Tuffey	ಟಫಿ
Tumhara	ತುಮ್ಹಾರಾ
Turco	ಟರ್ಕೊ
Ueberroth	ಯೂಬರೋತ್
Ujesh	ಉಜೇಶ್
Ulster	ಅಲ್ಸ್ಟರ್
United	ಯುನೈಟೆಡ್
Up	ಅಪ್
Usha	ಉಷಾ
Uthata	ಉಠತಾ
Utseya	ಉತ್ಸೆಯ
Vallar	ವಲ್ಲಾರ್
Vaulting	ವಾಲ್ಟಿಂಗ್
Veinticinco	ವೆಂಟಿಸಿಂಕೊ
Velcro	ವೆಲ್ಕ್ರೋ
Vembakottai	ವೆಂಬಕೋಟೈ
Venetian	ವೆನೆಟಿಯನ್
Venkatapathy	ವೆಂಕಟಪತಿ
Verizon	ವೆರಿಜಾನ್
Vesuvius	ವಿಸುವಿಯಸ್
Vibhushan	ವಿಭೂಷಣ
Vikalp	ವಿಕಲ್ಪ್
Vilenica	ವೆಲಿನಿಕಾ
Vivah	ವಿವಾಹ್
Vrashabh	ವೃಷಭ
Vrellis	ವ್ರೆಲ್ಲಿಸ್
Wahidul	ವಹಿದುಲ್
Wal	ವಾಲ್
Wala	ವಾಲಾ
Wallington	ವೆಲ್ಲಿಂಗ್ಟನ್
Wanda	ವಂದಾ
Wasim	ವಾಸಿಂ
Wax	ವ್ಯಾಕ್ಸ್
Whiting	ವೈಟಿಂಗ್
Whitman	ವ್ಹಿಟ್ಮ್ಯಾನ್
Whittall	ವಿಟ್ಟಾಲ್
Whoop	ವೂಪ್
Wijesuriya	ವಿಜಿಸುರಿಯಾ
Williamson	ವಿಲಿಯಂಸನ್
Wishart	ವಿಶಾರ್ಟ್
Wisneski	ವಿಸ್ನೆಸ್ಕಿ
With	ವಿತ್
Woh	ವಹ್
Wolfman	ವುಲ್ಫ್ಮ್ಯಾನ್
Woolley	ವೂಲೆ
Wüttemberg	ವುಟೆಂಬರ್ಗ್
Yadon	ಯಾದೋ
Yashodhar	ಯಶೋಧರ
Yogeendr	ಯೋಗೀಂದ್ರ
Zabbar	ಜಬ್ಬಾರ್
Zaheer	ಜಹೀರ್
Zellweger	ಜೆಲವೆಗರ್
Zeppelin	ಜೆಪೆಲಿನ್
Zindagi	ಜಿಂದಗಿ
Zion	ಜಿಯಾನ್
