Strong	השני
Mole	מול
Mole	מולה
Dunkelman	דונקלמנ
Tricolour	טריקולור
Ogaryovo	אוגריובו
Bergqvist	ברגקויסט
Susskind	זוסקינד
Japan	יפנ
Japan	יפני
Magan	מגנ
Crossman	קרוסמנ
Lina	לינה
Hadag	הדג
Deinard	דיינרד
Neogene	נאוגנ
Chauncey	צ'אנסי
Silvia	סילביה
Vilan	וילנ
Pollack	פולק
Pollack	פולאק
Piat	פיאט
Wildcat	ויילדקט
Krips	קריפס
Ballista	בליסטרה
Transcendentalism	טרנסצנדנטיות
Joselewicz	יוסלביצ'
Bian	ביאנ
Gaidar	גאידר
Yumjaagiin	יומג'אגינ
Imst	אימסט
Fertile	הפורה
Cannibalism	קניבליזמ
Dangermouse	דיינג'רמאוס
Precambrian	פרקמבריומ
Cosmos	קוסמוס
Chawla	צ'אולה
Snape	סנייפ
Katrina	קתרינה
Dakar	דקר
Miquelon	ומיקלונ
Whipple	ויפל
Hematuria	המטוריה
Tobago	וטובגו
Becket	בקט
Mascagni	מסקאני
Yochanan	יוחננ
Galilee	הגליל
Okon	אוקונ
Oscar	אוסקר
Saransk	סרנסק
Cosplay	קוספליי
Smashing	הסמאשינג
Applegate	אפלגייט
Organization	ויצו
Organization	ארגונ
Homotherium	הומוטריומ
Plantago	פלנטגו
Tropaion	טרופאיונ
Loftus	לופתוס
Gericke	גריקה
Plaza	פלאזה
Spenta	ספנטס
Krupnik	קרופניק
Tintin	טינטינ
Ilse	אילזה
Gluconeogenesis	גלוקונאוגנזה
Mansiysk	מנסייסק
Lichtenstein	ליכטנשטיינ
Jersey	ג'רזי
Rozental	רוזנטל
Magritte	מגריט
Torat	תורת
Richmond	ריצ'מונד
Majerle	מארלי
Whedon	וידונ
Emin	אמינ
Coffee	קפה
Mavericks	מאבריקס
Humanistic	הומניסטית
Bleiberg	בלייברג
Jarre	ז'אר
Condition	תנאי
Perestroika	פרסטרויקה
Biathlon	ביאתלונ
Sayeret	סיירת
Seraph	שרפ
Chipmunks	הציפמאנקס
Picquart	פיקאר
Harnoncourt	הארנונקור
Pancake	פנקייק
Bouskilla	בוסקילה
Beamon	בימונ
Beechcraft	אייר
Mass	מסה
Mass	מיסה
Vladivostok	ולאדיווסטוק
Vladivostok	ולדיווסטוק
Tureck	טורק
Universitario	אוניברסיטאריו
Serialism	סריאליזמ
Patras	פטרס
Emissivity	אמיסיביות
Eton	איטונ
Previn	פרווינ
Shirat	שירת
Fiji	פיג'י
Homeopathy	הומאופתיה
Ideal	אידאלי
Ideal	אידאל
Collagen	קולגנ
Zeuxis	זאאוקיס
Orava	אורבה
Oran	אוראנ
Ephor	אפור
Trivia	טריוויה
Hockney	הוקני
Maelstrom	מאלסטרומ
Reacher	ריצ'ר
Kreitman	קרייטמנ
Chikatilo	צ'יקטילו
Supersaurus	סופרזאור
Saingilo	סאינגילו
Pilsen	פילזנ
Lictor	ליקטור
Judas	ג'ודס
Shagor	שגור
Principal	פרינסיפל
Matterhorn	מטרהורנ
Oren	אורנ
Oren	ואורנ
Bergelson	ברגלסונ
Tull	טאל
Kristeva	קריסטבה
Hydrazine	הידרזינ
Barite	בריט
Havnar	הבנר
Kitsman	קוצמנ
Abijam	אבימ
Frankfort	פרנקפורט
Ares	ארס
Haram	חראמ
Stupa	סטופה
Carothers	קרותרס
Mace	מייס
Buchu	בוכו
Morocco	השישי
Morocco	מרוקו
Morgana	מורגנה
Betis	בטיס
Jude	ג'וד
Beham	בהאמ
Darkthrone	דארקת'רונ
Habanera	הבנרה
Mccullough	מקאלוג
Theodolite	תאודוליט
Ellipsoid	אליפסואיד
Champollion	שמפוליונ
Buchenwald	בוכנוואלד
Raistlin	רייסטלינ
Gnaeus	גנאיוס
Louganis	לוגניס
Flavell	פלאבל
Melchizedek	מלכיצדק
Wieland	וילנד
Utica	אוטיקה
Jawf	ג'ופ
Horizons	הוריזונס
Albrecht	אלברכט
Celibidache	צ'ליבידאקה
Thermophile	תרמופיל
Duilius	דואיליוס
Askeran	אסקראנ
Artichoke	ארטישוק
Jolie	ג'ולי
Simply	סימפלי
Paide	פאידה
Pastel	פסטל
Chatelier	שטליה
Ilmenite	אילמניט
Yarmouk	ירמוכ
Selenite	סלניט
Histidine	היסטידינ
Epoch	אפוק
Siro	סירו
Torii	טורי
Gelmetti	ג'למטי
Bhabha	באבא
Regev	רגב
Maurois	מורוא
Shamgar	שמגר
Juniors	ג'וניורס
Gamgee	גמג'י
Fechter	פכטר
Totem	טוטמ
Determinant	דטרמיננטה
Sabonis	סאבוניס
Hezbollah	חיזבאללה
Burger	ברגר
Cadmus	קדמוס
Hassium	האסיומ
Wyborowa	וויברובה
Television	טלוויזיה
Tanzanite	טנזניט
Bremerton	ברמרטונ
Nahari	נהרי
Berners	ברנרס
Cytokinin	ציטוקינינ
Clippers	קליפרס
Leeuwenhoek	לוונהוק
Shakers	שייקריזמ
Ashton	אשטונ
Censor	קנסור
Brassens	ברסנס
Gotlober	גוטלובר
Ella	אלה
Mostar	מוסטאר
Ketura	קטורה
Wahl	ואהל
Bruges	ברוז'
Salvia	סלוויה
Grandjany	גרנדיאני
Resheph	רשפ
Korah	קורח
Chacham	חכמ
Hamilcar	חמילקרת
Lysosome	ליזוזומ
Etgar	אתגר
Jharkhand	ג'הרקאנד
Homolysis	הומוליזה
Prednisone	פרדניזונ
Downhill	דאונ
Archaeology	בארכיאולוגיה
Archaeology	לארכיאולוגיה
Archaeology	ארכאולוגיה
Tetanus	טטנוס
Stack	סטק
Stack	סטאק
Kuala	קואלה
Frigate	פריגטה
Hypnos	היפנוס
Fall	פול
Water	ווטר
Cantata	קנטטה
Chodesh	חודש
Messerschmitt	מסרשמיט
Daliah	דליה
Polytechnic	טק
Yiddish	יידיש
Goleman	גולמנ
Tsakalidis	צאקאלידיס
Daman	דאמאנ
Kimberlite	קימברליט
Stargate	סטארגייט
Captaincy	קפיטניה
Ethnomusicology	אתנומוזיקולוגיה
Kakapo	קאקאפו
Akinnuoye	אקינויה
Huberman	הוברמנ
Broca	ברוקה
Redstone	רדסטונ
Transposition	טרנספוזיציה
Taiko	טאיקו
Trappists	טראפיסטימ
Muscle	שוק
Hawn	הונ
Koltur	קולטור
Zoroaster	זרתוסטרה
Toblerone	טובלרונ
Omnipotence	אומניפוטנטיות
Rowecki	רובצקי
Cutler	קאטלר
Kaniuk	קניוק
Caliph	ח'ליפ
Berlitz	ברליצ
Traudl	טראודל
Coenraad	קונרד
Pauli	פאולי
Boker	בוקר
Ringelnatz	רינגלנצ
Genizah	גניזה
Pavlova	פבלובה
Arno	ארנו
Aelia	איליה
Aelia	אאליה
Blind	בליינד
Lipopolysaccharide	ליפופוליסכריד
Velites	וליטס
Philolaus	פילולאוס
Leghorn	לגהורנ
Jive	ג'ייב
Live	לייב
Blog	בלוג
Ununquadium	אונונקוודיומ
Ornithology	אורניתולוגיה
Tuchman	טוכמנ
Bayit	בית
Sture	סטור
Imide	אימיד
Weininger	ויינינגר
Wales	ויילס
Tonic	טוניקה
Twist	טוויסט
Zappa	זאפה
Lindgren	לינדגרנ
Brandy	ברנדי
Zulu	זולו
Tragedy	טרגדיה
Rozhdestvensky	רוז'דסטוונסקי
Meghalaya	מגהלאיה
Katyusha	קטיושה
Hanikra	הנקרה
Trittico	טריטיקו
Premier	פרמייר
Alessandria	אלסנדריה
Mitrevski	מיטרבסקי
Westlife	וסטלייפ
Luntschitz	מלונטשיצ
Rosie	רוזי
Swiss	סוויס
Agoracritus	אגורקריטוס
Elite	אליטה
Fiordland	פיורדלנד
Osasuna	אוסאסונה
Wine	יינ
Helminthology	הלמינתולוגיה
Kimono	קימונו
Festival	פסטיבל
Supertonic	סופרטוניקה
Nargis	נרגיס
Enthroned	אנת'רונד
Maus	מאוס
Reinickendorf	רייניקנדורפ
Druid	דרואיד
Malt	מאלט
Karenina	קרנינה
Fantastique	הפנטסטית
Verhoeven	ורהובנ
Sagoth	סאגות'
Obote	אובוטה
Pompeius	פומפיוס
Hallein	האליינ
Ribosome	ריבוזומ
Vanir	ואניר
Archosaur	ארכוזאוריה
Eniac	אניאק
Perseus	פרסאוס
Limnology	לימנולוגיה
Inquisition	אינקוויזיציה
Inquisition	האינקוויזיציה
Dartmouth	דרטמות
Mazuwa	מזואה
Yigael	יגאל
Middlesbrough	מידלסברו
Adrien	אדריאנ
Confuciusornis	קונפוציוסאורניס
Alterman	אלתרמנ
Bacteriophage	בקטריופאג'
Berekhat	מברכת
Tallit	טלית
Zisling	ציזלינג
Bischofswerda	בישופסוורדה
Catalan	קטלנ
Catalan	קטלאנית
Manifesto	מניפסט
Manifesto	המניפסט
Zilpah	זלפה
Mantle	מנטל
Urbino	אורבינו
Hitlerum	היטלרומ
Negev	הנגב
Ramek	רמק
Bolivian	בוליביאנו
Steric	סטרי
Egyptology	אגיפטולוגיה
Chlamydia	כלמידיה
Odalisque	אודליסק
Choreography	כוריאוגרפיה
Royale	רויאל
Mayonnaise	מיונז
Balili	בלילי
Coalition	קואליציה
Godsmack	גודסמאק
Winters	וינטרס
Alcatraz	אלקטרז
Tweed	טוויד
Bitlis	ביטליס
Riyadh	ריאד
Kabir	כביר
Gilgal	גלגל
Chips	צ'יפס
Andalus	אנדלוס
Dybbuk	דיבוק
Dybbuk	הדיבוק
Xinjiang	שינג'יאנג
Vincennes	ונסנ
Shuriken	שוריקנ
Escudo	אסקודו
Hammerfall	האמרפול
Kaosayananda	קאוס
Optimization	אופטימיזציה
Geoglyph	גאוגליפ
Boleslav	בולסלאב
Nietzsche	ניטשה
Methamphetamine	מתאמפטמינ
Volynskyi	וולינסקי
Dionysios	דיוניסיוס
Control	קונטרול
Ununbium	אונונביומ
Siegel	סיגל
Roald	רואלד
September	ספטמבר
September	בספטמבר
Sorel	סורל
Frangelico	פרנג'ליקו
Gothic	גותי
Iscar	ישקר
Fireworks	פיירוורקס
Shatner	שאטנר
Scud	סקאד
Poodle	פודל
Groningen	חרונינגנ
Alendronate	אלנדרונט
Snoezelen	סנוזלנ
Astrobiology	אסטרוביולוגיה
Siren	סירנה
Placebo	פלסיבו
Placebo	פלסבו
Eliyashiv	אלישיב
Cournot	קורנו
Smash	סמאש
Malayalam	מליילמ
Refraction	השתברות
Urartu	אוררטו
Bourguiba	בורגיבה
Accent	אקסנט
Point	פוינט
Point	פואנ
Kershaw	קרשו
Sportsperson	ספורטאי
Rimsky	רימסקי
Biotin	ביוטינ
Abuja	אבוג'ה
Essequibo	אסקיבו
Toledot	תולדות
Curia	קוריה
Taoism	טאואיזמ
Emulator	אמולציה
Wolfgang	וולפגנג
Oldesloe	אולדסלו
Italo	איטלו
Italo	איטאלו
Unterwalden	אונטרוולדנ
Pimp	פימפ
Mandate	המנדט
Mandate	מנדט
Monism	מוניזמ
River	אוב
River	ריבר
Fontane	פונטאנה
Wedekind	ודקינד
Dyskinesia	דיסקינזיה
Bructeri	ברוקטרימ
Isotope	איזוטופ
Paradinas	פרדינס
Moreira	מוריירה
Shishman	שישמנ
Standard	הסטנדרטי
Standard	סטנדרט
Corpse	קורפס
Dadra	דאדרה
Nucleosome	נוקלאוזומ
Eemil	אמיל
Pneumatic	פנאומטיקה
Nasserism	נאצריזמ
Berserk	ברזרק
Xerophyte	קסרופיט
Necropolis	נקרופוליס
Ascension	אסנשנ
Ostinato	אוסטינטו
Hevel	חבל
Bardejov	ברדיוב
Pisseleu	פיסלה
Tutong	טוטונג
Depardieu	דפארדיה
Kantele	קנטלה
Engelbart	אנגלברט
Lumen	לומנ
Norwegian	נורבגית
Oreiro	אוריירו
Rashidun	ראשידונ
Dinar	דינר
Savimbi	סאווימבי
Dysplasia	דיספלסיה
Dysplasia	דיספלזיה
Hahiver	החיוור
Ragtime	רגטיימ
Sporophyte	ספורופיט
Degeneres	דג'נרס
Noyon	נואיונ
Cyanide	ציאניד
Adjika	אג'יקה
Nuweiba	נואיבה
Kokhba	כוכבא
Etiquette	אטיקט
Dunedin	דונדינ
Maxentius	מקסנטיוס
Kirkby	קרקבי
Keeshond	קיסהאונד
Alberstein	אלברשטיינ
Teledyne	טלדיינ
Samsung	סמסונג
Moldavian	מולדובה
Pyatigorsk	פיאטיגורסק
Großglockner	גרוסגלוקנר
Rust	רוסט
Photon	פוטונ
Sargent	סרג'נט
Nahash	נחש
Hauptbahnhof	האופטבנהופ
Amoeba	אמבה
Glissando	גליסנדו
Hypertext	היפרטקסט
Baktus	ובקטוס
Tachometer	טכומטר
Gambit	גמביט
Yehiel	יחיאל
Champloo	צ'מפלו
Drachma	דרכמה
Court	קורט
Alternative	אלטרנטיבי
Alternative	אלטרנטיבית
Alternative	אלטרנטיב
Bazargan	באזרגאנ
Lanka	לנקה
Sachertorte	זאכרטורטה
Kerem	כרמ
Lactamase	לקטמאז
Inheritance	ירושה
Glatzer	גלאצר
Sirtaki	סירטאקי
Scheel	של
Pakarinen	פאקאריננ
Eugen	אויגנ
Federalism	פדרליסטימ
Paparuda	פפרודה
Winnipeg	ויניפג
Revava	רבבה
Mariotte	מריוט
Magnetron	מגנטרונ
Aegyptopithecus	אגיפטופיתקוס
Mechanics	מכניקת
Mechanics	מכניקה
Poltergeist	פולטרגייסט
Polymorphism	פולימורפיזמ
Magnetosphere	מגנטוספירה
Hadean	האדנ
Edom	אדומ
Braudel	ברודל
Elvin	אלווינ
Pyroxene	פירוקסנ
Caridis	קארידיס
Teena	טינה
Summerslam	סאמרסלאמ
Symphony	סימפוניה
Insei	אינסיי
Professor	פרופסורת
Professor	פרופסור
Albano	אלבנו
Goulash	גולאש
Carbide	קרביד
Trampolining	טרמפולינה
Mahalalel	מהללאל
Ostracism	אוסטרקיזמ
Chillul	חילול
Abendroth	אבנדרות
Muktzah	מוקצה
Hippocampus	היפוקמפוס
Hatserim	חצרימ
Hufu	הופו
Clytemnestra	קליטמנסטרה
Woodstock	וודסטוק
Brisighella	בריזיגלה
Jethou	ג'ת'ו
Antigone	אנטיגונה
Paderewski	פדרבסקי
Gleichschaltung	גלייכשאלטונג
Kittel	קיטל
Alpi	אלפי
Tisza	טיסה
Baddeley	באדלי
Wyndham	וינדהמ
Calcite	קלציט
Beckinsale	בקינסייל
Photochromism	פוטוכרומיזמ
Cymric	קימריק
Mekhilta	מכילתא
Effector	אפקטור
Raytheon	ריית'אונ
Cenozoic	קנוזואיקונ
Northrop	נורת'רופ
Xenolith	קסנולית
Milwaukee	מילווקי
Frisia	פריזיה
Muhammad	מוחמד
Empathogen	אמפתוגנ
Lebesgue	לבג
Gatcombe	גייטקומב
Platonic	אפלטונית
Steaua	סטיאווה
Israeli	ישראלי
Pogrom	פוגרומ
Jamaal	ג'מאל
Flames	פליימס
Samoa	סמואה
Rhythm	רית'מ
Eshkol	אשכול
Geocentric	הגאוצנטרי
Marada	מרדה
Elbrus	אלברוס
Brutus	ברוטוס
Molotov	מולוטוב
Reflexology	רפלקסולוגיה
Dieting	דיאטה
Chastain	צ'סטיינ
Mihrab	מחראב
Archaeopteryx	ארכיאופטריקס
Symphonie	הסימפוניה
Categorical	הקטגורי
Fiefdom	פיפ
Kermeur	קרמר
Starbuck	סטארבק
Magnetic	מגנטית
Guerrouj	גרוז'
Spritz	שפריצ
Phenethylamine	פנתילאמינ
Kumis	קומיס
Klaf	קלפ
Hilberg	הילברג
Arkhangai	ארחאנגאי
Eponym	אפונימ
Krems	קרמס
Mackensen	מקנזנ
Whalsay	וולסיי
Jacksonville	ג'קסונוויל
Frankenstein	פרנקנשטיינ
Ignoratio	איגנורטיו
Vaygach	וייגאצ'
Berel	ברל
Browning	בראונינג
Yonah	יונה
Panamax	פנמקס
Bibliotherapy	ביבליותרפיה
Ravina	רבינא
Pedy	פאדי
Photosphere	פוטוספירה
Genesis	ג'נסיס
Gamer	גיימר
Kell	קל
Caucasus	קווקז
Mirs	מירס
Meitnerium	מייטנריומ
Tenacious	טניישס
Vayechi	ויחי
Hayarok	הירוק
Jannings	יאנינגס
Pilcomayo	פילקומיו
Edgard	אדגר
Jonze	ג'ונז
Burmese	בורמזי
Jethro	יתרו
Jethro	ג'ת'רו
Phytochrome	פיטוכרומ
Janco	ינקו
Ahijah	אחיה
Staatsrat	שטאטסראט
Anapsid	אנאפסידה
Preferans	פרפראנס
Corso	קורסו
Attack	אטאק
Energy	אנרגיה
Herts	הרצ
Yolanda	יולנדה
Regalim	רגלימ
Klagenfurt	קלגנפורט
Mead	מיד
Glubb	גלאב
Ilanit	אילנית
Sper	ספרי
Rhin	ריינ
Fondi	פונדי
Vlade	ולאדה
Scotia	סקוטיה
Tomasson	תומסונ
Quenya	קווניה
Lesbos	לסבוס
Gratian	גרטיאנוס
Sundhage	סונדהאגה
Polystyrene	פוליסטירנ
Lumpur	לומפור
Rubidium	רובידיומ
Bias	ביאס
Frankfurter	פרנקפורטר
Militia	מיליציה
Chakraborty	צ'קרבורטי
Govi	גובי
Shochat	שוחט
Ascalon	אשקלונ
Fleet	פליט
Dmowski	דמובסקי
Modica	מודיקה
Hierarchy	ההיררכייה
Hierarchy	היררכיה
Arvydas	ארבידאס
Thelonious	ת'לוניוס
Jaana	יאנה
Physical	פיזיקלית
Schattenburg	שאטנבורג
Flash	פלאש
Sloughi	סלוגי
Beate	ביאטה
Arjen	אריינ
Mchale	מקהייל
Zerach	זרח
Skynyrd	סקינרד
Napoca	נאפוקה
Scharf	שרפ
Gilchrist	גילכרייסט
Director	דיירקטור
Cassiopeia	קסיופאה
Sappho	סאפפו
Gemma	ג'מה
Orient	אוריינט
Dangerfield	דיינג'רפילד
Capitolina	קפיטולינה
Lieutenant	לויטנט
Houdini	הודיני
Labello	לבלו
Humorului	הומורולוי
Antithesis	אנטיתזה
Tahini	טחינה
Pratitya	פראטיטיה
Culkin	קולקינ
Operator	אופרטור
Gyllene	יילנה
Hyginus	היגינוס
Kartlos	כרתלוס
China	סינ
China	צ'יינה
Valois	ולואה
Sirhan	סירחאנ
Majdanek	מיידנק
Svetitskhoveli	סווטיצחובלי
Shakhtar	שחטאר
Roach	רוצ'
Melvins	מלווינס
Moroi	מורוי
Phlogiston	פלוגיסטונ
Nitzani	ניצני
Racha	רצ'ה
Babruysk	בוברויסק
Corday	קורדיי
Mariss	מאריס
Ununseptium	אונונספטיומ
Drapetomania	דראפטומניה
Jenny	ג'ני
Muezza	מואזה
Ricimer	ריקימר
Kanna	כנא
Manstein	מאנשטיינ
Khrizantema	כריזנטמה
Mesika	מסיקה
Rumkowski	רומקובסקי
Berthe	ברת
Benkler	בנקלר
Ansfelden	אנספלדנ
Zhovkva	ז'ובקבה
Chord	אקורד
Spitz	ספיצ
Tironut	טירונות
Sholokhov	שולוחוב
Hewitt	יואיט
Robustus	רובוסטוס
Duani	דואני
Ansel	אנסל
Bhubaneswar	בובנשוואר
Kanun	קאנונ
Hawk	הוק
Halmstad	האלמסטאד
Shamosh	שמוש
Holtzberg	הולצברג
Phobia	פוביה
Kharkiv	חרקוב
Buffon	בופונ
Mapping	מיפוי
Lughnasadh	לונאסה
Galway	גולוויי
Gallico	גאליקו
Girl	גירל
Ornithopod	אורניתופודה
Statistics	סטטיסטיקה
Agreste	אגרסטה
Norther	נורת'ר
Darnah	דרנה
Kartl	כארתלי
Benzema	בנזמה
Barkan	ברקנ
Masur	מאזור
Yzerman	אייזרמנ
Chitin	כיטינ
Sandman	סאנדמנ
Hudaydah	חודיידה
Cubism	קוביזמ
Guillotine	גיליוטינה
Hava	הבה
Cobalt	קובלט
Thermodynamics	תרמודינמיקה
Racine	רסינ
Stardust	סטארדאסט
Novus	נובוס
Eino	אינו
Gebirtig	גבירטיג
Dogville	דוגוויל
Agenda	אג'נדה
Mongolia	מונגוליה
Gurbanguly	גורבנגולי
Individualist	אינדיבידואליסטי
Chrysoberyl	כריזובריל
Condon	קונדונ
Ecotope	אקוטופ
Tulchyn	טולצ'ינ
Akon	אקונ
Nezval	נזוול
Skandha	סקנדה
Melanin	מלנינ
Gether	גתר
Hispania	היספניה
Rize	ריזה
Tarvisio	טרוויזיו
Berkovic	ברקוביצ'
Vian	ויאנ
Schur	שור
Therapsida	תראפסידה
Buffalo	באפלו
Borzage	בורזאג'
Freak	פריק
Immortal	אימורטל
Gaudio	גאודיו
Zilber	זילבר
Mcdyess	מקדייס
Cosmogony	קוסמוגוניה
Membrane	ממברנה
Kiss	קיס
Miss	מיס
Dunga	דונגה
Pytheas	פיתאס
Achilles	אכילס
Cormorant	קורמורנימ
Marocchinate	מארוקינאטה
Grechko	גרצ'קו
Wien	וינה
Elser	אלזר
Gere	גיר
Evergrey	אברגריי
Bordeaux	בורדו
Nirenberg	נירנברג
Arbeitman	ארבייטמנ
Origami	אוריגמי
Microtome	מיקרוטומ
Orff	אורפ
Tauber	טאובר
Optics	אופטיקה
Effects	אפקטס
Effects	אפקט
Filiki	פיליקי
Shiratori	שירטורי
Gentle	ג'נטל
Chancellors	קאנצלר
Krishnamurti	קרישנמורטי
Bingo	בינגו
Shafaq	שאפאק
Almon	אלמונ
Samoyed	סמוייד
Cratylus	קראטילוס
Paliashvili	פליאשווילי
Majdal	מג'דל
Conforte	קונפורטי
Magna	מגנה
Ampoule	אמפולה
Manhigut	מנהיגות
Mortara	מורטארה
Tucholsky	טוכולסקי
Netiquette	נטיקה
Mesudarim	מסודרימ
Hell	הל
Fuad	פואד
Teratogenesis	טרטוגנ
Ratosh	רטוש
Juhuri	ג'והורי
Tribune	טריבונ
Zoroastrianism	זורואסטריות
Amasya	אמסיה
Borsec	בורסק
Khaldei	חאלדיי
Albright	אולברייט
Broza	ברוזה
Dumars	דיומרס
Castaway	קאסטאווי
Panait	פנאיט
Baron	וב
Baron	ברונ
Baron	ביירונ
Baron	הברונ
Bagshot	באגשוט
Cytogenetics	ציטוגנטיקה
Desperation	דספריישנ
Andropov	אנדרופוב
Eileithyia	איליתיה
Ochamchire	אוצ'מצ'ירה
Epigoni	אפיגוני
Myrtilus	מירטילוס
Lysol	ליזול
Elbegdorj	אלבגדורג'
Averbukh	אברבוכ
Marais	המארה
Marais	מארה
Smirnoff	סמירנופ
Postnik	פוסטניק
Masmuda	מסמודה
Electrode	אלקטרודה
Asulin	אסולינ
Jinn	ג'ינ
Bazaar	והבזאר
Babur	באבור
Velociraptor	ולוצירפטור
Troposphere	טרופוספירה
Pekahiah	פקחיה
Guth	גות'
Ramones	ראמונס
Killers	הקילרס
Sashimi	סשימי
Brynner	ברינר
Potocki	פוטוצקי
Mishmar	משמר
Elementary	אלמנטרית
Valine	ולינ
Sarabande	סרבנד
Ginny	ג'יני
Salinometer	סלינומטר
Periscope	פריסקופ
Kenobi	קנובי
Građanski	גראדאנסקי
Chase	צ'ייס
Bone	בונ
Hemoglobin	המוגלובינ
Akhaltsikhe	אחלציחה
Berenice	ברניקי
Etoumbi	אטומבי
Benkow	בנקוב
Czerniak	צ'רניאק
Krupp	קרופ
Arsenide	ארסניד
Moor	מור
Westerweel	וסטרויל
Nuremberg	נירנברג
Amotz	אמוצ
Frazier	פרייזר
Brezhneva	ברז'נייבה
Bodel	בודל
Somua	סומואה
Yukawa	יוקאווה
Southern	סאת'רנ
Husayni	חוסייני
Cuvier	קובייה
Orot	אורות
Parapsychology	פאראפסיכולוגיה
Sparrow	ספארו
Thrombosis	תרומבוס
Galante	גאלאנט
Elis	אליס
Pardes	פרדס
Union	אוניה
Sailor	סיילור
Haayal	האייל
Shaprut	שפרוט
Tehomi	תהומי
Lanier	לנייר
Yetzirah	יצירה
Delta	דלתא
Delta	דלתה
Yerushalayim	ירושלימ
Euryapsida	פראפסידה
Mithras	מיתרה
Offenbach	אופנבכ
Captain	קפטנ
Fermion	פרמיונ
Conglomerate	קונגלומרט
Cement	צמנט
Traun	טראונ
Goblin	גובלינ
Messenia	מסניה
Anderlecht	אנדרלכט
Chlorus	כלורוס
Tnuva	תנובה
Megumi	מגומי
Deductive	דדוקציה
Buccaneers	באקנירס
Agatharchides	אגאתרכידס
Rayman	ריימנ
Pilaf	פילאפ
Gelfand	גלפנד
Mosquito	מוסקיטו
Keret	קרת
Lesseps	לספס
Browder	ברוודר
Onassis	אונאסיס
Yoram	יורמ
Philby	פילבי
Saruq	סרוק
Hipparchia	היפרכיה
Emil	אמיל
Silmarillion	הסילמריליונ
Ulvaeus	אולבאוס
Elohim	אלוהימ
Lykhny	לוחני
Ellipse	אליפסה
Amarth	אמארת'
Emmerich	אמריכ
Hanami	האנאמי
Lavrentiy	לברנטי
Vigintisexviri	ויגינטיסקסוירי
Chromatography	כרומטוגרפיה
Saparmurat	ספרמורט
Pseudomorph	פסאודומורפיזמ
Shirer	שיירר
Gayatri	גאיטרי
Binaisa	בינייסה
Merlin	מרלינ
Barber	בארבר
Minimal	מינימלי
Minimal	מינימל
Megalopolis	מגלופוליס
Hummer	האמר
Nepos	נפוס
Yuval	יובל
Arrigo	אריגו
Pune	פונה
Goldmark	גולדמארק
Midreshet	מדרשת
Tadeusz	טדאוס
Tadeusz	תדאוש
Tadeusz	תדיאוש
Fawzi	פאוזי
Thesis	תזה
Merce	מרס
Rhenium	רניומ
Tabbai	טבאי
Sakari	סאקארי
Moriendi	מוריינדי
Vauvenargues	וובנארז'
Pennsylvania	פנסילבניה
Barrett	בארט
Henson	הנסונ
Nathans	נתנס
Paparizou	פפאריזו
Steroid	סטרואיד
Purine	פורינ
Rawaki	ראוואקי
Karavan	קרוונ
Gauss	גאוס
Phasor	פאזור
Wand	ואנד
Jabberwocky	ג'ברווקי
Gellius	גליוס
Sycomorus	שקמה
Cajal	קאז'אל
Rysanek	ריזאנק
Jakarta	ג'קרטה
Meister	מייסטר
Praxiteles	פרקסיטלס
Chujiro	צ'וג'ירו
Compostela	קומפוסטלה
Olimpico	אולימפיקו
Edensor	אדנזור
Phonetic	הפונטי
Ureno	וראינה
Kooser	קוסר
Habitus	הביטוס
Knopfler	נופלר
Fruitarianism	פרוקטרייניזמ
Renaissance	רנסאנס
Pankiewicz	פאנקייוויצ'
Blobel	בלובל
Bohr	בוהר
Anthropology	אנתרופולוגיה
Paulownia	פאולוניה
Svevo	זבבו
Urology	אורולוגיה
Bagot	באגוט
Nouveau	נובו
Biophysics	ביופיזיקה
Kapp	קאפ
Jamaica	ג'מייקה
Khurtsidze	חורצידזה
Patch	פאטצ'
Kras	קראס
Flor	פלור
Landor	לנדור
Tractor	טרקטור
Byte	בית
Theudas	תוידאס
Sauckel	זאוקל
Gladiator	גלדיאטור
Galadriel	גלדריאל
Gader	גדר
Pleistocene	פליסטוקנ
Yated	יתד
Agbaje	אגבג'ה
Prisoner	האסיר
Moldovenesc	מולדובנסק
Lilongwe	לילונגווה
Kaduri	כדורי
Asthma	אסתמה
Buck	בק
Aretha	אריתה
Stratosphere	סטרטוספירה
Marathi	מרטהי
Peppard	פפארד
Vayeshev	וישב
Courante	קוראנט
Weasley	ויזלי
Decidendi	דיסידנדי
Hegemony	הגמוניה
Schist	שיסט
Nouvelle	נובל
Creveld	קרפלד
Fforde	פורד
Samadhi	סמדהי
Scholem	שלומ
Friedan	פרידנ
Kippur	כיפור
