Marianne	מאריאן
Hetfield	היטפילד
Trasch	טראש
Smalley	סמולי
Cavalieri	קאבאליירי
Hawass	חאואס
Clayderman	קליידרמאן
Bachchan	באצ'אן
Morley	מורלי
Szoke	סזוק
Rehovot	רחובות
Pulci	פולשי
Bronte	ברונטי
Joseph	ג'וזף
Cornwell	קורנויל
Ethiopian	אתיופיאן
Tudor	טודור
Cassatt	קאסאט
Madsen	מאדסן
Dutton	דאטן
Antarctica	אנטארקטיקא
Lynn	לין
Nemo	נמו
Poupakis	פופאקיס
Halonen	האלונין
Kolodziejczak	קולודזיטשאק
Cindy	סינדי
Gaetano	גאיטאנו
Geddes	גידיס
Ventimiglia	וינטמיליא
Bellini	ביליני
Political	פוליטיקל
Hasekura	האסיקורא
Natale	נאטאלי
Kumar	קומאר
Fredrik	פרידריק
Kumai	קומאי
Kitts	קיטס
Sienkiewicz	סינקיביטש
Berti	ברטי
Arturo	ארטורו
Poulantzas	פולאנצאס
Figueroa	פיגירוא
Sberbank	סבירבנק
Stam	סטאם
Herbin	הרבן
Imbarek	אמבארק
Seki	סקי
Grisham	גרישאם
Milo	מאילו
Giovanna	ג'ובאנא
Blunt	בלאנט
Lymari	לימארי
Tokimune	טוקימונה
Filo	פאילו
Cantor	קאנטור
Matthias	מאטיאס
Basri	בסרי
Larsson	לארסון
Graziani	גראציאני
Vemic	וימיטש
Peary	פירי
Barazite	באראזאיט
Aurel	אורל
Kazimova	קאזימובא
Poseidon	פוסידון
Tanasuwan	טאנאסוואן
Shui	שוי
Donnie	דאני
Bergman	ברגמאן
Fatfat	פאטפאט
Ryutaro	ריוטארו
Chenene	צ'נן
Pearl	פירל
Diabate	דיאבייט
Pedros	פידרוס
Kornel	קורנל
Jackie	ג'קי
Uzbekistan	אוזבקיסטאן
Arief	עריף
Shammas	שמאס
Nara	נארא
Laigle	לייגל
Oumar	עומר
Ariel	אריאל
Nisanit	ניסנית
Connie	קוני
Bakri	בקרי
Nicolas	ניקולאס
Drogba	דרוגבא
Fellini	פיליני
Milito	מיליטו
Audrey	אודרי
Brede	ברידי
Miloud	מילוד
Orlev	אורליב
Nadir	נדיר
Michael	מאיקל
Kalashnikov	קלאשניקוב
Mpumalanga	מפומאלאנגא
Rubin	רובין
Rubio	רוביו
Yom	יום
Latina	לאטינא
Rubik	רוביק
Law	לו
Gallup	גאלופ
Shamsul	שמסול
Bonnie	בוני
Shakshouka	שקשוקה
Asad	אסד
Schrijvers	שריברז
Nissim	נסים
Avishai	אבישי
Putin	פוטין
Mukhtar	אלמוכטאר
Chadwick	צ'אדויק
Wagdi	ואגדי
Dionysus	דיוניסוס
Galler	גאלר
Pallister	פאליסטר
Sudbury	סודברי
Bakdash	בקדאש
Feiglin	פייגלין
Tikopia	טיקופיא
Chacour	שקור
Grier	גריר
Friedmann	פרידמאן
Norfolk	נורפולק
Dvora	דבורה
Dotchev	דוצ'ב
Ľubomir	לובומיר
Lafuente	לאפוינטי
Staudinger	שטאודינגר
Sabbatai	שבתאי
Mexico	מקסיקו
Khatibi	חטיבי
Haggard	האגארד
Dagher	דאגר
Titu	טיטו
Belgrano	בילגראנו
Burgess	בורגיס
Djakpa	ג'אפקא
Ardabil	ארדביל
Anatoly	אנאטולי
Terasoma	טיראסומא
Adolf	אדולף
Magda	מאגדה
Maharashtra	מאהאראשטרא
Karadzic	קאראדיטש
Zerouali	זרואלי
Pepper	פיפר
Hunke	הונקה
Saari	סערי
Kyel	קיל
Faulk	פולק
Morales	מוראליס
Chamran	צ'מראן
Badir	באדר
Schacht	שאכט
Peng	פינג
Takaaki	תקאקי
Swaile	סוייל
Javier	חאבייר
Heng	הינג
Gillars	גילרז
Santiago	סנטיאגו
Matteo	מאטאו
Totoro	טוטורו
Cassin	קאסין
Doom	דום
Canizares	קאניזאריס
Shannon	שאנון
Zetlitz	זיטליץ
Shabtai	שבתאי
Yvonne	ייבון
Marian	מאריאן
Kusch	קוש
Kobushi	קובושי
Gohouri	גוהורי
Reinhard	רינהארד
Hitman	היטמאן
Roshan	רושאן
Riccardo	ריקארדו
Walcott	ואלקוט
Ascoli	אסקולי
Ayan	עיאן
Hipolito	היפוליטו
Columbus	קולומבוס
Gaetan	גאיטאן
Bjarne	ביארן
Norgay	נורגיי
Pattinson	פאטינסון
Kuyt	קויט
Smetana	סמיטנא
Gabriela	גאבריאלה
Mcgrady	מקגריידי
Rocha	רושא
Rieu	ריו
Server	סירבר
Jacob	ג'ייקוב
Djilali	ג'ילאלי
Ajami	ע'גמי
Northam	נורתאם
Hirota	הירוטא
Mubarek	מובארק
Messali	מסאלי
Sperone	ספירוני
Madison	מאדיסן
Vela	וילא
Weikart	וייקארט
Gaziantep	גאזיאנטפ
Carolina	קארולאינא
Yamaoka	יאמאוקא
Bela	בילא
Vyazma	ויאזמא
Wisconsin	ויסקונסן
Tanzania	טנזאניא
Macho	מאצ'ו
Najib	נג'יב
Spiegler	ספיגלר
Wiseman	ואיזמאן
Robles	רובלז
Milutinovic	מילוטינוביטש
Litton	ליטון
Ceni	סני
Sandri	סאנדרי
Gerald	ג'ראלד
Nyilasi	נילאסי
Boll	בול
Demidov	דמידוב
Puhl	פול
Ruhl	רול
Vaart	וארט
Granado	גראנאדו
Passarella	פאסארילא
Homayoun	הומאיון
Gerard	ג'רארד
Bksy	בקסי
Xavier	זייביאר
Stewart	סטיוארט
Buson	בוסון
Deby	דבי
Arlen	ארלין
Shraga	שרגא
Moneo	מוניו
Kimi	קימי
Albayyati	אלבאיאטי
Mimi	מימי
Maathai	מאתאי
Desai	דסאי
Alansari	אלאנסארי
Myriam	מיריאם
Heraclius	הראקליוס
Jameson	ג'יימסון
Chilembe	צ'ילמבי
Diatta	דיאטא
Charvet	טשארוויט
Rockmond	רוקמונד
Sanou	סאנו
Belkacem	בלקאסם
Nash	נאש
Franky	פראנקי
Hurst	הורסט
Shoaib	שועיב
Dhiab	דיאב
Zweyer	זוואיר
Woodward	וודוארד
Meszoly	מיסזולי
Transnistria	טראנסניסטריא
Mughrabi	מוגרבי
Portas	פורטאס
Nachshon	נחשון
Troy	טרוי
Gilardino	גילארדינו
Tiger	טאיגר
Fiasco	פיאסקו
Mutiu	מוטיו
Monsef	מונסף
Jamieson	ג'מיסון
Pascale	פאסקאל
Lakis	לאקיס
Lassana	לאסאנא
Naismith	נייסמית
Nabeel	נביל
Gurpegui	גורפיגי
Menegazzo	מיניגאזו
Santini	סאנטיני
Shaaban	שעבאן
Woodville	וודביל
Shandong	שאנדונג
Cusco	קוסקו
Theodore	תיודור
Coppola	קופולא
Saqr	סאקר
Danyel	דאניאל
Motran	מוטראן
Fiona	פיונא
Marathon	מאראתון
So	סו
Shaath	שעת
Planus	פלאנוס
Berezutski	ברזוצקי
Noah	נואה
Kleinert	קלאינירט
Silverstone	סילברסטון
Iftar	איפטאר
Bo	בו
Kentaro	קינטארו
Aires	אריס
Bonnissel	בוניסל
Dulce	דולסי
Zdenek	זדיניק
Blake	בלייק
Chuck	צ'אק
Marrakchi	מראקשי
Stephanie	סטיפאני
Pakradouni	פקראדוני
Chekhov	צ'כוב
Yonatan	יונתן
Routledge	רוטלדיגص
Nouzaret	נוזארה
Blaby	בלייבי
Hidekatsu	הידיקאטסו
Toujan	טוג'אן
Kfar	כפר
Corfu	קורפו
Metropolitana	מטרופוליטאנא
Afar	עפאר
Meir	מאיר
Razak	רזק
Grenada	גרינאדא
Noor	נור
Lucas	לוקאס
Buljan	בוליאן
Mernissi	מרניסי
Lurz	לורז
Masaccio	מאסאצ'ו
Souza	סוזא
Martelli	מארטילי
Harari	הרארי
Komljenovic	קומלינוביטש
Giichi	גיצ'י
Yui	יוי
Deco	דיקו
Georgia	ג'ורג'א
Luyindula	לויינדולא
Clift	קליפט
Boaz	בועז
Kiyotaka	קיוטאקא
Gazankulu	גאזאנקולו
Tunisia	טוניסיה
Hui	הוי
Rosenbaum	רוזנבאום
Valladares	ואלאדאריס
Bunraku	בונראקו
Czeslaw	צ'יסלאב
Saenko	סאינקו
Faisal	פאיסל
Wall	וול
Hall	הול
Batu	באטו
Ruffalo	רופאלו
Ball	באל
Sosuke	סוסוקה
Scherzinger	שירזינגר
Carrier	קאריאר
Stifter	סטיפטר
Bielsa	בילסא
Toldo	טולדו
Kant	קאנט
Ximena	שימינא
Murawski	מוראוסקי
Pinocchio	פינוקיו
Yatom	יתום
Vyntra	וינטרא
Pipes	פאיפס
Spetsnaz	ספיטסנאז
Tremoulinas	טרימולינאס
Tortosa	טורטוסא
Myskina	מיסקינא
Missouri	מיזורי
Beckett	ביקיט
Daniel	דניאל
Hahn	האן
Jahn	יאן
Kahn	קאהן
Jundiaad	ג'ונדיאד
Bijotat	ביג'וטאט
Sukur	סוקור
Per	פיר
Confucius	קונפיושוס
Parker	פארקר
Huffman	הופמאן
Grigori	גריגורי
Timisoara	טימישוארא
Hakovesh	הכובש
Sedarous	סידארוס
Mer	מר
Kiribati	קיריבאטי
Dzurinda	דזורינדא
Der	דר
Haysbert	הייזבירט
Deveric	דיביריטש
Ger	גר
Fulci	פולקי
Pepsi	פפסי
Muhamed	מוחמד
Mazar	מזאר
Kerry	קירי
Jimenez	חימנז
Noriega	נורייגא
Crowe	קרו
Madre	מאדרי
Elin	אלין
Joya	ג'ויא
Almodovar	אלמודובאר
Battisti	באטיסטי
Gioachino	ג'ואקינו
Corzo	קורזו
Just	ג'אסט
Shosh	שוש
Yeshayahu	ישעיהו
Funke	פונקה
Davison	דאביסון
Dunkirk	דאנקירק
Sendhil	סנדהיל
Vincent	וינסנט
Lajos	לאיוס
Karami	קראמי
Bergougnoux	בירגוניו
Hernan	הירנאן
Lerby	לרבי
Mottram	מוטראם
Carter	קארטר
Fiennes	פיאנס
Spiropoulos	ספירופולוס
Sanli	סאנלי
Kazaz	קאזאז
Dragonair	דראגונייר
Morini	מוריני
Bartolomeo	בארטולומיו
Kocharyan	קוצ'אריאן
Mdledle	מדלידלי
Kazan	קאזאן
Mitchel	מיטשל
Barhom	ברהום
Frederick	פרידיריק
Combs	קומז
Beslan	בסלאן
Rogier	רוג'יר
Francesco	פראנשיסקו
Cyndi	סינדי
Poncelet	פונסלה
Marzouk	מרזוק
Rashomon	ראשומון
Francesca	פראנססקא
Zaven	זאבין
Lengeh	לנגה
Shinji	שינג'י
Đuric	דוריטש
Gorshkov	גורשקוב
Diakite	דיאקיטי
Kozo	קוזו
Vernon	ורנון
Hasek	האסיק
Ana	אנא
Husbands	האזבינדז
Ravier	ראוייר
Moizan	מויזאן
Duff	דאף
Krav	קרב
Jagdeo	ג'אגדיו
Lesnar	ליסנר
Fonseca	פונסיקא
Facchetti	פאקיטי
Boltzmann	בולצמאן
Jafargholi	ג'עפרגולי
Corradi	קוראדי
Novartis	נובארטיס
Zib	זיב
Bhutto	בוטו
Ilana	אילנה
Showtaro	שוטארו
Inca	אינקא
Gregoire	גריגויר
Comte	קומט
Johannes	יוהאנס
Piccoli	פיקולי
Nobutoshi	נובטושי
Taddei	טאדיי
Raab	ראב
Hirschfeld	הירשפילד
Drazen	דראזין
Galite	גאליטה
Dib	דיב
Benayahu	בנאיאהו
Guenon	גוינון
Palminteri	פאלמינטרי
Edubuntu	אדובונטו
Adana	עדאנא
Barnetta	בארניטא
Conte	קונטי
Miklos	מיקלוס
Lucescu	לוקיסקו
Capek	קאפק
Yann	יאן
Capet	קאפה
Baecke	בקי
Oklahoma	אוקלאהומא
Doxa	דוקסא
Kamikawa	קאמיקאוא
Gibb	גיב
Sionko	סיונקו
Danon	דאנון
Nazar	נזאר
Wassily	ואסילי
Pizarro	פיזארו
Robertson	רוברטסון
Tartarus	טארטארוס
Bamyan	באמיאן
Volvo	וולבו
Ricardo	ריקארדו
Livnat	ליבנת
Mikhail	מיכאיל
Boniek	בוניק
Speer	ספיר
Mitzpe	מצפה
Wade	וייד
Henryk	הנריק
Rainea	ראיניא
Stipe	סטיפ
Niepce	ניפס
Tomoko	טומוקו
Catalonia	קאטאלוניא
Speed	ספיד
Vassily	ואסילי
Dickson	דיקסון
Kobayashi	קובאיאשי
Havard	האוארד
Henrik	הנריק
Michalik	מיכאליק
Eliza	אליזא
Miodrag	מיודראג
Corrado	קוראדו
Greengrass	גרינגראס
Buddha	בודהא
Foucault	פוקו
Kasey	קייסי
Benzarti	בנזארטי
Balboa	באלבוא
Levinson	לווינסון
Kleberson	קליברסון
Frasco	פראסקו
Laertius	לירטיוס
Gregor	גריגור
Rizal	ריזאל
Hellinger	הילנגר
Sheryl	שיריל
Mokoena	מוקוינא
Stelmach	סטילמאטש
Frisk	פריסק
Aguilar	אגוילאר
Yaguchi	יאגוצ'י
Wittmann	ויטמאן
Dzeko	דזיקו
Derby	דרבי
Mcnab	מאקנאב
Jasem	ג'אסם
Namikawa	נאמיקאוא
Guity	גיטי
Mignogna	מיניונא
Federer	פדרר
Fossey	פוסי
Welter	ולטר
Tomiko	טומיקו
Twal	טואל
Freire	פרייר
Mercosur	מירקוסור
Malalai	מלאלאי
Renaud	רינו
Cadillac	קאדילאק
Francois	פרנסוא
Baidachny	באידאצ'ני
Andrea	אנדריא
Shabazi	שבזי
Andria	אנדריא
Zhuk	זהוק
Antananarivo	אנטאנאנאריבו
Raver	רייבר
Tatlin	טאטלין
Maserati	מסיראטי
Matilda	מאטילדא
Kit	קיט
Bromothymol	ברומותימול
Mit	מיט
Wasilewski	ואסילוסקי
Bit	ביט
Thaler	טאלר
Ishak	איסחאק
Fantini	פאנטיני
Petronio	פיטרוניו
Spain	ספיין
Junayd	ג'ונייד
Noether	נותר
Ruislip	רוסליפ
Woody	וודי
Frojdfeldt	פרוידפילדט
Fanteni	פאנטיני
Discovery	דיסקברי
Morty	מורטי
Alfazari	אלפזארי
Karkar	קארקאר
Naser	נאסר
Diogenes	דיוגניז
Igor	איגור
Yassa	יאסא
Henriksen	הנריקסן
Cernan	סירנאן
Rasizade	ראסיזאדה
Morte	מורטי
Smith	סמית
Mitsuaki	מיטסואקי
Chaim	חיים
Elyakim	אליקים
Sokho	סוכו
Tariq	טאריק
Serzh	סירז'
Kinshasa	קינשאסא
Sahashi	סאהאשי
Fazah	פזה
Mehanna	מהנא
Vanessa	ואניסא
Popper	פופר
Lahham	לחאם
Lamborghini	לאמבורגיני
Munaron	מונארון
Tarin	טארין
Duo	דואו
Yves	איב
Hardin	הארדין
Tarik	טאריק
Brynjar	בריניאר
Giacinto	ג'אסינטו
Sarit	שרית
Belyzel	ביליזל
Fuseli	פוסלי
Paxton	פאקסטן
Truth	טרות
Rie	ריה
Harden	הארדן
Balmer	באלמר
Ljubinko	ליובינקו
Patagonia	פאטאגוניא
Giorgi	גיורגי
Aloysius	אלאוישס
Lie	לאי
Napolitano	נאפוליטאנו
Maldera	מאלדירא
Hmam	חמאם
Strauss	סטראוס
Manuel	מאנויל
Gamberini	גאמביריני
Sarin	סארין
Mashal	משעל
Emam	אמאם
Hannigan	האניגאן
Sverkos	סבירקוס
Nazem	נאזם
Gertrude	גירטרוד
Geynrikh	גיاנריך
Coulais	קולייס
Yoshino	יושינו
Gamsakhurdia	גאמסאכורדיא
Casey	קייסי
Jordan	ג'ורדאן
Miroslav	מירוסלאב
Galileo	גאלילאו
Adorno	אדורנו
Basel	באסל
Vanhanen	ואנהאנין
Hleb	הליב
Pamarot	פאמארוט
Rashidi	רשידי
Ammo	עמו
Irakleio	איראקליו
Temotu	טימוטו
Kristiansen	קריסטיאנסן
Kawakami	קאואקאמי
Nocerino	נוצ'ירינו
Fridman	פרידמאן
Lavey	לייבי
Varga	וארגא
Reiner	ראינר
Laver	לאבר
Dalnet	דאלנט
Golda	גולדא
Boubacar	בובקר
Haris	חאריס
Malfoy	מאלפוי
Kanepi	קאניפי
Valderrama	ואלדיראמא
Blanc	בלאנק
Lazaro	לאזארו
Holguin	הולגוין
Matlin	מאטלין
Jostein	ג'וסטאין
Zwartkruis	זוארטקרויס
Megalodon	מיגאלודון
Sibenik	סיביניק
Paisley	פייזלי
Karaboue	קאראבויה
Vicki	ויקי
Salvador	סלבאדור
Hemidi	חמידי
Mcgraw	מאקגראו
Nojima	נוג'ימא
Thys	תיס
Sophus	סופוס
Valon	ואלון
Hjalmar	היאלמאר
Aland	אלאנד
Ernesto	ארנסטו
Lendl	לינדל
Tassadit	טסעדיט
Verkhoyansk	וירכויאנסק
Bullard	בולארד
Hebron	חברון
Diablo	דיאבלו
Toumani	טומאני
Barroso	בארוסו
Polyhymnia	פוליהימניא
Osborn	אוסבורן
Paphos	פאפוס
Donskoy	דונסקוי
Capello	קאפילו
Nizam	ניזאם
Katanec	קאטאניטש
Cassano	קאסאנו
Spiro	ספירו
Nizar	ניזאר
Fukui	פוקוי
Gemmrich	גימריטש
Alzheimer	אלזהאימר
Ezra	עזרא
Heiner	הינר
Dunstaple	דאנסטאפל
Kendo	קנדו
Vioarsson	ויוארסון
Tskhinvali	טסכינבאלי
Benjamin	בנג'אמין
Metzger	מצגר
Marvin	מארוין
Buster	באסטר
Dassault	דאסולט
Mapai	מפאי
Adel	עאדל
Hissene	חיסן
Okuma	אוקומא
Zangwill	זאנגויל
Weiner	וינר
Alcntara	אלקנטארא
Mario	מאריו
Turbo	טורבו
Dino	דינו
Antonin	אנטונין
Marie	מארי
Tsabet	טסאבט
Baekeland	ביקלאנד
Sophocles	סופוקליז
Maria	מאריא
Tycho	טיכו
Gromyko	גרומיקו
Yakubu	יאקובו
Ramsey	ראמסיי
Ramsay	ראמסיי
Foggia	פוג'יא
Passy	פאסי
Salloukh	סאלוך
Lady	ליידי
Schrojf	שרויף
Pancoast	פנקוסט
Makaay	מקאי
Naveh	נוה
Shikma	שיקמא
Jacques	ז'ק
Antar	ענטר
Eliahu	אליאהו
Kaishu	קאישו
Borden	בורדן
Kasonde	קאסונדי
Taiwo	טאיוו
Haibin	האיבין
Beilin	בילין
Giuliani	ג'וליאני
Derek	דרק
Mihail	מיהאיל
Karin	קארין
Cristea	קריסטיא
Lebron	ליברון
Netzer	נצר
Fallaj	פלאג'
Balhous	בלחוס
Legend	לג'נד
Doody	דודי
Akkad	עקאד
Miskito	מיסקיטו
Kournikova	קורניקובא
Siniora	סניורה
Shehzad	שהזאד
Fran	פראן
Leviev	לבייב
Gugino	גוגינו
Madono	מאדונו
Plus	פלאס
Toro	טורו
Gyula	גיולא
Verne	וירן
Daryl	דאריל
Gregory	גריגורי
Chalme	צ'אלמי
Sethrida	סתרידא
Flohe	פלוה
Sarton	סארטון
Columbia	קולומביא
Platini	פלאטיני
Rosario	רוזאריו
Cheryl	שיריל
Titov	טיטוב
Erikson	אריקסון
Ticleanu	טיקליאנו
Fortaleza	פורטאליזא
Hooke	הוק
Karlsruhe	קארלסרוה
Foiros	פוירוס
Kajiura	קאג'יורא
Whelan	וילאן
Mahr	מאר
Paulino	פאולינו
Palmachim	פלמחים
Sedonoude	סידונודי
Didier	דידייה
Fourest	פוריסט
Harsanyi	הארסאני
Bangalore	באנגאלור
Nikola	ניקולא
Bissau	ביסאו
Kirkilas	קירקילאס
Teofilo	טיופילו
Djite	דג'יטי
Sriti	סריטי
Ethel	איתיל
Imre	אימרי
Jurg	יורג
Berrer	בירר
Kanfory	קאנפורי
Kasdan	קאסדאן
Maier	מאיר
Garaudy	גארודי
Buigues	בויגיס
Klopp	קלופ
Shklovsky	שקלובסקי
Tadao	טאדאו
Bardon	בארדון
Sadat	סאדאת
Dokhi	דוכי
Alfa	אלפא
Gavrilov	גאברילוב
Stoltz	סטולץ
Asturias	אסטוריאס
Nkrumah	נקרומא
Tajikistan	טאג'יקסטאן
Falco	פאלקו
Vietnam	וייטנאם
Belleri	בלירי
Ojeili	עוג'יילי
Sitting	סיטינג
Gunnar	גונאר
Mcindoe	מאקינדו
Deledda	דילידא
Shao	שאו
Colette	קוליט
Jurgen	יורגין
Rudakov	רודאקוב
Winona	וינונא
Zungul	זונגול
Viduka	וידוקא
Holzenbein	הולזנבאין
Delisle	דילאיל
Endless	אנדליס
Zahir	זאהיר
Alfredo	אלפרידו
Hamdani	חמדאני
Richards	ריצ'ארדז
Slavko	סלאבקו
Massawa	מאסאוע
Broz	ברוז
Lewandowski	ליבאנדובסקי
Pluskal	פלוסקאל
Safin	סאפין
Jaouad	ג'ואד
Dario	דאריו
Babacar	באבאקר
Horizonte	הוריזונטי
Capac	קאפאק
Irit	אירית
Gateshead	גייטסהיד
Dominika	דומיניקא
Middendorf	מידנדורף
Henchoz	הינצ'וז
Parana	פאראנא
Hansson	האנסון
Taye	טאי
Seth	סית
Kollontai	קולונטאי
Google	גוגל
Reveillere	ריביליר
Kaye	קיי
Bachelet	באשילה
Pazdan	פאזדאן
Taleb	טאלב
Westenra	וסטנרא
Rafik	רפיק
Bek	בק
Kopke	קופקה
Beth	בת
Timbaland	טמבלנד
Faye	פיי
Rudi	רודי
Sorrentino	סורנטינו
Sales	סיילז
Gottlob	גוטלוב
Winograd	וינוגראד
Hadar	הדר
Masai	מאסאי
Yakin	יאקין
Berggren	בירגרין
Hasse	האס
Issyk	איסיק
Budi	בודי
Seamus	שיימוס
Hayabusa	האיאבוסא
Baric	באריטש
Kerrigan	קיריגאן
Hafiz	חאפז
Gargo	גארגו
Traore	טראורי
Allenby	אלנבי
Vitor	ויטור
Saleh	סאלח
Hadad	חדאד
Hostilius	הוסטיליוס
Willy	וילי
Lucilio	לוסיליו
Hartman	הארטמאן
Zakopane	זאקופאנא
Gnome	נום
Ganim	גנים
Rigoberta	ריגובירטא
Monfils	מונפיס
Naoki	נאוקי
Gelsenkirchen	גילסנקירשן
Raleb	ראלב
Vincente	וינסינט
Naoko	נאוקו
Potter	פוטר
Schmid	שמיד
Gish	גיש
Lowe	לו
Breuer	ברויר
Pisin	פיסין
Almaimani	אלמאימני
Bedrich	בדריש
Monza	מונזא
Redfa	רדפא
Tiomkin	טיומקין
Kuznetsov	קוזניטסוב
Dimitar	דימיטאר
Meridor	מרידור
Wonder	וונדר
Lofthouse	לאפטהאוס
Batistuta	באטיסטוטא
Harold	הארולד
Salpigidis	סאלפיגידיס
Husayn	חוסיין
Fukuyama	פוקויאמא
Buscemi	בושימי
Hoshino	הושינו
Tahir	טאהיר
Massa	מאסא
Potomac	פוטומאק
Arutz	ערוץ
Mills	מילז
Batumi	באטומי
Cuiaba	קויאבא
Khusainov	חוסיינוב
Lenglen	לנגלן
Husain	חוסיין
Tupac	טופאק
Timur	טימור
Milli	מילי
Cerny	קירני
Drnovsek	דרנובסיק
Summerbee	סאמרבי
Bernd	בירנד
Berne	ברן
Yeltsin	ילטסין
Garbarek	גארבארק
Berni	בירני
Leila	לילא
Nakamura	נאקאמורא
Farid	פריד
Famke	פאמקי
Qantas	קואנטאס
Sahin	סאהין
Charisteas	חאריסטיאס
Redha	רדא
Faris	פאריס
Salzburg	סאלזבורג
Gleick	גליק
Kadar	קאדאר
Keaton	קיטון
Tamagnini	טאמאגניני
Laxness	לאקסנס
Almahdi	אלמהדי
Bonano	בונאנו
Chalabi	צ'לבי
Rosi	רוסי
Thalmann	תאלמאן
Daninos	דאנינוס
Wislawa	ויסלאוא
Uzeyir	עוזייר
Mizuki	מיזוקי
Galilei	גאליליי
Kiril	קיריל
Yukari	יוקארי
Hata	האטא
Yekini	יקיני
Hashimoto	האשימוטו
Eduardo	אדוארדו
Hmede	חמידה
Malek	מאלק
Walton	ואלטון
Franciscan	פרנסיסקן
Richard	ריצ'ארד
Zein	זיין
Mensah	מינסאה
Dirac	דיראק
Askar	עסקר
Skiles	סקאילז
Kunitsyn	קוניטסין
Topi	טופי
Mezzogiorno	מידזוגורנו
Molnar	מולנאר
Harada	האראדא
Yoshio	יושיו
Mein	מיין
Nein	נאין
Clarkson	קלארקסון
Henkin	הנקין
Haytham	היתם
Nishizawa	נאשיזאוא
Will	ויל
Hill	היל
Asimo	אסימו
Ashour	עאשור
Newman	ניומאן
Yusa	יוסא
Behcet	בהקט
Bill	ביל
Milsom	מילסום
Zakir	זאקיר
Fontaine	פונטיין
Zanzibar	זנזיבאר
Juliette	ג'וליאט
Sark	סארק
Octonion	אוקטוניון
Musa	מוסא
Motti	מוטי
Wark	וארק
Ak	אק
Mark	מארק
Shotokan	שוטוקאן
Compton	קומפטון
Maclaine	מאקליין
Trabzon	טראבזון
Edmonton	אדמונטון
Mounier	מוניר
Knapp	קנאפ
Takeda	טאקידא
Saadavi	סאדאבי
Casas	קאסאס
Mulligan	מוליגאן
Ferrini	פיריני
Wohrer	ווהרר
Mansfield	מאנספילד
Abbassi	עבאסי
Bakari	באקארי
Modi	מודי
Dae	דיי
Sforza	ספורזא
Mosisili	מוסיסילי
Dodi	דודי
Travers	טראברז
Eris	אריס
Debbie	דבי
Yajima	יאג'ימא
Amr	עמר
Keach	קיטש
Toriumi	טוריומי
Simovic	סימוביטש
Lara	לארא
Mara	מרה
Marulanda	מארולאנדא
Myra	מאירא
Baudelaire	בודליר
Frideric	פרידריק
Hassanal	חסנל
Hagai	חגי
Denver	דנבר
Diamond	דיאמונד
Baalbek	בעלבק
Lukacs	לוקאש
Amos	עמוס
Stoppard	סטופארד
Kubuntu	קובונטו
Macanga	מאקאנגא
Santos	סאנטוס
Kaysone	קאיסון
Desailly	דיסאיי
Ujfalusi	אויפאלוסי
Kiyoura	קיורא
Golmohammadi	גולמוחמדי
Riedl	רידל
Warren	וארן
Nairobi	נאירובי
Rajko	ראיקו
Bakshi	באקשי
Zahavi	זהבי
Shasta	שאסטא
Rajoelina	רג'ולינא
Citigroup	סיטיגרופ
Dugarry	דוגארי
Ginola	גינולא
Aref	עארף
Madrasah	מדרסה
Morikawa	מוריקאוא
Soltani	סולטאני
Cartman	קארטמאן
Magnin	מאגנין
Nimeiry	נמיירי
Lathan	לאתאן
Bunche	באנש
Ayoob	איוב
Sonu	סונו
Leopold	ליופולד
Spencer	ספנסר
Lahm	לאם
Ramos	ראמוס
Edward	אדוארד
Takis	טאקיס
Crippen	קריפן
Noriaki	נוריאקי
Kurosaki	קורוסאקי
Moslem	מוסלם
Woodley	וודלי
Badar	בדר
Maxi	מאקסי
Jahin	ג'אהין
Ramon	ראמון
Corriere	קורייר
Yoshihiro	יושיהירו
Katzrin	קצרין
Novak	נובאק
Eva	איבא
Senderos	סינדירוס
Haig	הייג
Wallis	ואליס
Krauss	קראוס
Pagani	פאגאני
Sejdiu	סידיו
Smicer	סמאיסר
Alonzo	אלונזו
Pasdar	פאסדאר
Riley	ראילי
Atarot	עטרות
Chrysostome	קריסוסטום
Lule	לולי
Crouch	קראוטש
Apostol	אפוסטול
Gbagbo	גבאגבו
Daley	דיילי
Chatwin	צ'אטוין
Varlam	וארלאם
Mavros	מאברוס
Indian	אינדיאן
Georg	גאורג
Nanami	נאנאמי
Scot	סקוט
Handal	חנדל
Semshov	סימשוב
Jaromir	יארומיר
Ubayy	אובאי
Duvall	דובאל
Darijo	דאריו
Kagan	קאגאן
Bandeira	באנדירא
Littbarski	ליטבארסקי
Mahfoud	מחפוד
Tatarstan	טאטארסטאן
Fritz	פריץ
Herzliya	הרצליה
Roxas	רוקסאס
Diab	דיאב
Vidal	וידאל
Jame	ג'יים
Kander	קאנדר
Truman	טרומאן
Sawa	סאווא
Balel	באלל
Lansbury	לאנסבורי
Karlheinz	קארלהאינז
Ghannouchi	גנוצ'י
Aquitaine	אקויטיין
Putnam	פוטנאם
Hainan	האינאן
Obsidian	אובסידיאן
Barnaul	בארנול
Zhao	ז'או
Dawa	דאוה
Porsche	פורש
Baley	באלי
Nathan	נייתן
Kovac	קובאטש
Dogg	דוג
Masako	מאסאקו
Sektioui	סקטיוי
Lorimer	לורימר
Svehlik	זביהליק
Therdsak	תרדסאק
Faudel	פאדל
Wiley	ואילי
Nobusuke	נובוסוקה
Burnley	בורנלי
Lorca	לורקא
Chao	צ'או
Kirschenbaum	קירשנבאום
Wiles	ואילז
Thissen	תיסן
Calabria	קאלאבריא
Rasputin	ראספיוטין
Bilharz	בילהארץ
Braque	בראק
Hakim	חאקים
Lantos	לאנטוס
Windhoek	וינדהוק
Tuva	טובא
Giacomo	ג'אקומו
Serotonin	סירוטונין
Stjepan	סטיפאן
Erez	ארז
Lancaster	לאנקסטר
Crosby	קרוסבי
Stoker	סטוקר
Irina	אירינא
Lucius	לוסיוס
Carroll	קארול
Maarouf	מערוף
Wakim	ואקים
Khallikan	חליקאן
Miralem	מיראלם
Munro	מונרו
Park	פארק
Shlomi	שלומי
Galen	גיילן
Zapater	זאפאטיר
Nagai	נאגאי
Narongchai	נארונגצ'אי
Nisan	ניסאן
Sprinzak	שפרינצק
Mansour	מנסור
Acuna	אקונא
Habibi	חביבי
Bedjaoui	בג'אוי
Miles	מאילז
Granite	גראניט
Kenzo	קנזו
Baraja	באראכא
Tzorvas	צורוואס
Zoellick	זוליק
Debra	דיברא
Silverstein	סילברסטאין
Murakami	מוראקאמי
Sartre	סארטר
Borussia	בורוסיא
Starkovs	סטראקובס
Silicone	סיליקון
Alkane	אלקיין
Bahia	באהיא
Parfait	פארפاיט
Heath	הית
Sybille	סיביל
Vanunu	וענונו
Takayuki	טאקאיוקי
Bahir	בהיר
Kumaratunga	קמאראטונגא
Daihatsu	דאיהאטסו
Afrikaner	אפריקאנר
Petain	פיטאן
Korean	קוריאן
Andrei	אנדריי
Dagan	דגן
Toshio	טושיו
Aleksandr	אלקסנדר
Mcconaughey	מאקונאהי
Grove	גרוב
Wehr	ור
Rome	רום
Bulleh	בולה
Tosh	טוש
Ragheb	ראגב
Wome	וומי
Sagisu	סאגיסו
Natalie	נאטאלי
Trevor	טריבור
Josh	ג'וש
Lome	לום
Maximus	מקסימוס
Knightley	נאיטלי
Fehr	פיהר
Ramamurthy	ראמאמורתי
Raghib	ראגיב
Briggs	בריגז
Durkovic	דרקוביטש
Poom	פום
Room	רום
Gamzatov	גמזטוב
Scifo	סקיפו
Nantes	נאנטס
Gotsmanov	גוטסמאנוב
Luccin	לוקין
Nidal	נידאל
Valentia	ואלינטיא
Zavarov	זאבארוב
Scarlatti	סקארלאטי
Trimurti	טרימורטי
Selman	סלמאן
Vecchio	ויקצ'יו
Mugihito	מוגיהיטו
Adriano	אדריאנו
Hameed	חמיד
Dmitri	דמיטרי
Yoko	יוקו
Propolis	פרופוליס
Bento	בינטו
Hilary	הילארי
Kroto	קרוטו
Ricci	ריצ'י
Polak	פולאק
Tobey	טובי
Gorlitz	גורליץ
Sheba	שיבא
Suazo	סואזו
Dallas	דאלאס
Dissa	דיסא
Vancouver	ואנקובר
Balotelli	באלוטילי
Penelope	פנלופי
Gadish	גאדיש
Yano	יאנו
Michigan	מישיגאן
Timor	טימור
Glasgow	גלאסגו
Tripoli	טריפולי
Serafin	סראפין
Antalya	אנטאליא
Cisse	סיסי
Lauren	לורן
Hendry	הנדרי
Yokohama	יוקוהאמא
Kano	קאנו
Chandra	צ'אנדרא
Missaoui	מיסאוי
Zalessky	זאלסקי
Afia	עאפיה
Sarsgaard	סארסגארד
Rietveld	ריטוילד
Baltimore	באלטימור
Crayford	קרייפורד
Keats	קיטס
Rehnquist	רינקויסט
Khalifah	חליפה
Asahara	אסאהארא
Heioar	הייור
Donadel	דונאדיל
Mariette	מארייט
Pienaar	פינאר
Linder	לינדר
Yolande	יולאנד
Thornton	תורנטון
Viljo	ויליו
Hal	האל
Pakito	פאקיטו
Malloum	מעלום
Simon	סאימון
Buhari	בוהארי
Bihar	ביחאר
Graner	גראנר
Lupescu	לופיסקו
Hitler	היטלר
Sali	סאלי
Tali	טלי
Laurens	לורנס
Sela	סילא
Sinai	סאינאי
Milner	מילנר
Todenhofer	טודנהופר
Mali	מאלי
Fagan	פייגן
Ioannis	יואניס
Sisley	סיסלי
Bali	באלי
Farran	פאראן
Dali	דאלי
Sampson	סאמפסון
Kostunica	קוסטוניקא
Ritter	ריטר
Ethane	אתיין
Massamasso	מאסאמאסו
Cassidy	קאסידי
Dudayev	דודאייב
Alice	אליס
Swinton	סוינטון
Majewski	מאג'וסקי
Honduras	הונדוראס
Artzi	ארצי
Malatesta	מאלאטיסטא
Almaty	אלמאטי
Yuki	יוקי
Spina	ספינא
Broadbent	ברודבנט
Gallas	גאלאס
Matovinovic	מאטובינוביטש
Denizli	דניזלי
Tare	טארי
Miyano	מיאנו
Sonia	סוניא
Guiza	גויזא
Kare	קארי
Koiso	קויסו
Hesperides	היספירידיס
Romney	רומני
Ronit	רונית
Antonescu	אנטוניסקו
Kafur	קאפור
Candide	קאנדיד
Zhiyi	ז'יי
Shawki	שאוקי
Maariv	מעריב
Detlev	דיטליב
Stepan	סטיפאן
Armenia	ארמיניא
Cory	קורי
Antarctic	אנטארקטיק
Toufic	טופיק
Vladimir	ולאדימיר
Sotomayor	סוטומאיור
Guccini	גוצ'יני
Miami	מאיאמי
Azzam	עזאם
Zhi	ז'י
Laughter	לאפטר
Fahima	פהימה
Rydell	רידל
Baker	בייקר
Emile	אמיל
Ryoko	ריוקו
Shi	שי
Papas	פאפאס
Moteab	מוטעב
Hardaway	הארדאויי
Luis	לויס
Riise	רייסה
Knox	נוקס
Burns	בירנז
Almog	אלמוג
Wassiou	ואסיו
Kapo	קאפו
Branko	בראנקו
Kenneth	קינית
Blum	בלום
Ghana	גאנא
Kahana	כהנא
Fandel	פאנדל
Tzipi	ציפי
Lessig	ליסיג
British	בריטיש
Chamakh	שמאך
Karnataka	קארנאטאקא
Arango	אראנגו
Qalqilyah	קלקיליה
Soumbeila	סומביילא
Lowell	לואל
Mongi	מונגי
Monge	מונג
Takaya	טאקאיא
Nigam	ניגאם
Limor	לימור
Moustaki	מוסטאקי
Karzai	קרזאי
Winslet	וינסליט
Luyckx	לוקס
Kragujevac	קראגוג'יבאק
Soros	סורוס
Schindler	שינדלר
Heihachiro	הייהאצ'ירו
Radanovic	ראדאנוביטש
Stravinsky	סטראבינסקי
Philippines	פיליפינז
Cass	קאס
Malaren	מאלארין
Mannin	מאנין
Blanka	בלאנקא
Shumei	שומיי
Mikis	מיקיס
Nicolita	ניוקליטא
Vanderlei	ואנדרלי
Mikio	מיקיו
Otmar	אוטמאר
Abraj	אבראג'
Mikulas	מיקולאס
Rovaniemi	רובאניאמי
Holst	הולסט
Heichel	האישל
Pteranodon	פטיראנודון
Maurice	מוריס
Juliano	ג'וליאנו
Moriri	מורירי
Harrelson	הארלסון
Zaidiyyah	זאידיה
Digao	דיגאו
Ossetia	אוסטיא
Piraeus	פיראוס
Domenech	דומיניק
Kaufmann	קופמאן
Moniz	מוניז
Aube	אוב
Cube	קיוב
Kary	קארי
Mary	מרי
Franjo	פראניו
Harnik	הארניק
Cary	קארי
Juliet	ג'ולייט
Guggenheim	גוגנהאים
Gary	גארי
Franco	פראנקו
Prso	פרסו
Nestor	נסטור
Headey	הידי
Geert	גירט
Rusudan	רוסודאן
Kennedy	קינידי
Metsu	מיטסו
Grint	גרינט
Whitaker	ויטאקר
Jorginho	ג'ורג'יניו
Nonacosane	נונאקוסיין
Rama	ראמא
Lung	לונג
Watteau	ואטו
Heike	היק
Tertullian	טרטליאן
Aung	אונג
Hashomron	השומרון
Lama	לאמא
Xuereb	זויריב
Mahler	מאהלר
Rotaru	רוטארו
Kentucky	קנטאקי
Caracalla	קאראקלא
Fama	פאמא
Palotai	פאלוטאי
Mcdonnell	מקדוניל
Philippoussis	פיליפוסיס
Cosmo	קוסמו
Khuwaylid	חואילד
Pardo	פארדו
Morello	מורילו
Capecchi	קאפיקי
Konin	קונין
Albin	אלבין
Vittorio	ויטוריו
Junichi	ג'וניצ'י
Turlough	טורלו
Aristides	אריסטידיס
Verilog	וירילוג
Fazlagic	פאזלאגיטש
Kessai	קיסאי
Theodorakis	תיודוראקיס
Movie	מובי
Flitter	פליטר
Dagano	דאגאנו
Samuel	סאמואל
Silviu	סילביו
Kikuchi	קיקוצ'י
Clemens	קלימינז
Radomir	ראדומיר
Mula	מולא
Klein	קלאין
Lederberg	לידרברג
Kozynkevych	קוזינקיביטש
Ramirez	ראמיריז
Barthes	בארט
Kuni	קוני
Tyler	טאילר
Kimberly	קימברלי
Todor	טודור
Combat	קמבאט
Rensing	רינסניג
Hingis	הינגיס
Diwali	דיואלי
Svensson	סוינסון
Makasa	מאקאסא
Pourcel	פורסל
Juhfiyah	ג'וחפיה
Nahuatl	נאהואטל
Reyes	רייס
Asmahan	אסמהאן
Pletikosa	פליטיקוסא
Hirz	חירז
Mulla	מולא
Zheng	ז'נג
Vashti	ושתי
Titicaca	טיטיקאקא
Moresby	מורסבי
Đinđic	גינגיטש
Nolan	נולאן
Tehran	טהראן
Atomic	אטומיק
Ron	רון
Petar	פיטאר
Ľubos	לובוס
Velazquez	וילאזקיז
Hon	הון
Ion	איון
Jon	ג'ון
Nonie	נוני
Emmanuel	עמנואל
Kherson	חירסון
Morozevich	מורוזיביטש
Don	דון
Kinnear	קיניאר
Congo	קונגו
Mcauliffe	מאקאוליף
Sven	סוון
Aphrodite	אפרודאיטי
Brittany	בריטאני
Palmas	פאלמאס
Dolinsky	דולינסקי
Lampros	לאמפורוס
Wimmer	וימר
Hilarion	הילאריון
Syngman	סינגמאן
Assisi	אסיסי
Pappe	פאפה
Shearim	שיארים
Monica	מוניקא
American	אמריקן
Dayro	דאירו
Kuntz	קונץ
Zivaljevic	זיבאלייביטש
Yerushalmi	ירושלמי
Bongo	בונגו
Seedorf	סידורף
Rafe	רפה
Naumann	נאומאן
Fattouh	פטוח
Haniyeh	הניה
Again	אגיין
Devon	דיבון
Hirobumi	הירובומי
Hrithik	הריתיק
Tomohiro	טומוהירו
Hirofumi	הירופומי
Takayama	טאקאיאמא
Sirous	סירוס
Woodgate	וודגייט
Cuauhtemoc	קואטימוק
Meucci	מיוצ'י
Selma	סלמא
Elfriede	אלפרידי
Chakvetadze	צ'אקויטאדזה
Phenylketonuria	פינאילקיטונוריא
Puerto	פוארטו
Ronnie	רוני
Mangnall	מאנגנאל
Tonetto	טוניטו
Polleunis	פולינס
Bikin	ביקין
Stein	סטאין
Relmy	רילמי
Walworth	ואלוורת
Murray	מרי
Melpomene	מילפומיני
Yasumoto	יאסמוטו
Hardy	הארדי
Bahro	באהרו
Leibniz	לאיבנץ
Luke	לוק
Dre	דרי
Medellin	מידילין
Roko	רוקו
Hubail	חובייל
Mariot	מאריוט
Bronstein	ברונסטין
Hoko	הוקו
Moro	מורו
Stoch	סטוטש
Rochemback	רוצ'מבאק
Loko	לוקו
Zichron	זכרון
Edmond	אדמונד
Darfur	דארפור
Rachmaninoff	רכמאנינוף
Dado	דאדו
Rachel	רייצ'ל
Fado	פאדו
Jonathan	ג'ונתן
Fazrul	פאזרול
Sabrina	סאברינא
Gareth	גארית
Grazer	גרייזר
Combin	קומבין
Dismas	דיסמאס
Nakata	נאקאטא
Zitouni	זייטוני
Childs	צ'אילדז
Papadopoulos	פאפאדופולוס
Fairuz	פאירוז
Damarcus	דאמארקוס
Istra	איסטרא
Gennady	גינאדי
Myles	מאילז
Xabi	שאבי
Gaborone	גאבורון
Rita	ריטא
Tajura	טאג'ורא
Labone	לאבון
Dickens	דיקנז
Neeskens	ניסקינז
Tabi	טאבי
Lita	ליטא
Nita	ניטא
Galimzyan	גאלימזיאן
Bloch	בלוך
Jabi	ג'אבי
Peltola	פלטולא
Yorkshire	יורקשיר
Gita	גיטא
Temime	טמים
Babi	באבי
Bernardo	ברנארדו
Doron	דורון
Mardy	מארדי
Chanov	צ'אנוב
Gabi	גבי
Tetsu	טטסו
Bob	בוב
Ajram	ע'גרם
Alfred	אלפרד
Revie	ריבי
Prion	פריון
Amin	אמין
Everest	אברסט
Brechet	בריטשיט
Pasteur	פאסטור
Desiree	דיזירה
Ras	ראס
Safy	סאפי
Familia	פאמיליא
Sheraton	שראטון
Bene	בני
Hank	האנק
Ziegler	זיגלר
Stiliyan	סטיליאן
Toshiki	טושיקי
Hirohashi	הירוהאשי
Zuchardt	צוכארט
Roudhan	רודאן
Turunen	טורונין
Lviv	לביב
Husseini	חוסייני
Kirk	קירק
Suleiman	סוליימאן
Shalala	שלאלא
Forough	פורוג
Kissinger	קיסינג'ר
Praia	פראיא
Bigon	ביגון
Benaderet	בנאדרת
Bakala	באקאלא
Rasheed	רשיד
Buarque	בוארק
Yavne	יבנה
Makdisi	מקדיסי
Manama	מנאמה
Cedric	סידריק
Nunez	נוניז
Liamine	ליאמין
Heggy	הגי
Summer	סאמר
Garbutt	גארבוט
Sur	סור
Sommeil	סומיל
Goldziher	גולדזיהר
Blok	בלוק
Jaafari	ג'עפרי
Chandrika	צ'אנדריקא
Rodin	רודאן
Seymour	סימור
Milorad	מילוראד
Khachaturian	חאצ'אטוריאן
Klas	קלאס
Normandy	נורמאנדי
Loa	לוא
Curtin	קורטין
Blas	בלאס
Sjaak	סיאק
Sho	שו
Manfred	מאנפרד
Kantaria	קנטאריא
Vojislav	וויסלאב
Goa	גוא
Macmillan	מאקמילאן
Zhvania	ז'באניא
Corsica	קורסיקא
Cho	צ'ו
Houston	היוסטן
Brett	בריט
Twain	טויין
Luxembourg	לוקסמבורג
Georgi	ג'ורג'י
Sarkis	סארקיס
Nevzlin	ניבזלין
Lamberto	לאמברטו
Howard	האוארד
Saudi	סעודי
Mahesh	מאהש
Hesham	השאם
Aghily	עגילי
Hasharon	השרון
Khouloud	חולוד
Savage	סאבאג'
Zverev	זביריב
Palahniuk	פאלאניוק
Mikoyan	מיקויאן
Tsuji	צוג'י
Tacconi	טאקוני
Huggel	האגל
Masing	מאסינג
Peixoto	פיקסוטו
Bracci	בראקי
Khalil	חליל
Lassina	לאסינא
Rawls	רולז
Azarenka	אזארינקא
Lovric	לובריטש
Igarashi	איגאראשי
Saito	סאיטו
The	תא
Bruckner	ברוקנר
Attias	אטיאס
Mancini	מאנשיני
Belloumi	בלומי
Levin	לוין
Adelstein	אדלסטין
Matrai	מאטראי
Mcdormand	מקדורמאנד
Ihara	איהארא
Wouters	ווטרס
Rocchi	רוקי
Delmotte	דילמוטי
Seigo	סייגו
Greta	גריטא
Jenyat	ג'ניאט
Burdenski	בורדינסקי
Harkus	הארקוס
Valdir	ואלדיר
Ardashir	ארדשיר
Gargano	גארגאנו
Ruppin	רופין
Dessau	דיסאו
Craxi	קראקסי
Frey	פריי
Troussier	טרוסיה
Kago	קאגו
Eloui	עלוי
Rocco	רוקו
Marriner	מארינר
Wiener	וינר
Cezanne	סיזאן
Gago	גאגו
Ghaly	גאלי
Niue	ניו
Karembeu	קארימבו
Wren	רן
Shaheen	שאהין
Veselin	וסילין
Valens	ואלנס
Lazaros	לאזארוס
Hudhayfah	חודייפה
Himmler	הימלר
Gide	גיד
Elisha	אלישע
Hemed	חמד
Jongbloed	יונגבלויד
Elista	אליסטא
Elissa	אליסא
Sverre	סוירי
Minor	מינור
Derbyshire	דירבישאיר
Saca	סאקא
Haiti	האיטי
Kotarba	קוטארבא
Ravenna	ראבינא
Thijssen	תיסין
Bakhoum	באכום
Alabama	אלאבאמא
Hafid	חפיד
Cardo	קארדו
Butrus	בוטרוס
Tannenbaum	טאננבאום
Kevin	קווין
Irwin	אירוין
Khayyam	חיאם
Tzonis	טזוניס
Hasni	חסני
Kingsley	קינגסלי
Juninho	ג'ונינהו
Taranto	טאראנטו
Heigl	היגל
Helguson	הילגוסון
Lukas	לוקאס
Rogge	רוג
Buenos	בוינוס
Markus	מארקוס
Volterra	בולטירא
Wilhelmsson	וילהמסון
Anita	אניטא
Pepe	פפה
Sigourney	סיגורני
Convey	קונביי
Issta	איסטא
Renate	רינאט
Squillaci	סקוילאצ'י
Maldonado	מאלדונאדו
Cioran	סיוראן
Zalman	זלמאן
Tziolis	ציוליס
Bursac	בורסאטש
Canada	קנדא
Banksy	באנקסי
Kav	קאב
Laplace	לאפלאס
Zainab	זיאנב
Spiros	ספירוס
Turkmani	טורקמאני
Grenoble	גרינובל
Epaminondas	איפאמינונדאס
Zebari	זיבארי
Mendez	מינדיז
Bennington	בנינגטון
Miljoona	מילג'ונא
Mandala	מאנדאלא
Cavendish	קאבנדיש
Beatrix	ביאטריקס
Ingushetia	אנגושיטיא
Zelin	זילין
Fletcher	פליטשיר
Saveljic	סאבילייטש
Nakache	נקאש
Tanju	טאנג'ו
Masny	מאסני
Banana	בננה
Viktor	ויקטור
Nyathi	ניאתי
Fincher	פינשר
Shirley	שירלי
Timothee	טימותי
Suu	סו
Berdych	בירדיטש
Manitoba	מאניטובא
Owen	אוין
Guarneri	גוארניירי
Magdeburg	מאגדיבורג
Rod	רוד
Nozawa	נוזאוא
Nasheed	נאשיד
Garde	גארד
Nodia	נודיא
Dinant	דינאנט
Jonquet	ג'ונקויט
Astro	אסטרו
Cabrita	קאבריטא
Album	אלבום
Genrikh	גינריך
Osseiran	עוסייראן
Mahdavikia	מהדאוויקיא
Leigh	לי
Sanjo	סאנג'ו
Reza	רזא
Poul	פול
Bonetto	בוניטו
Ritsos	ריטסוס
Friedensreich	פרידנסראיש
Troisi	טרויסי
Oyama	אויאמא
Salviati	סאלביאטי
Kamamoto	קאמאמוטו
Baghdadi	בגדאדי
Narendra	נארינדרא
Guernsey	גירנזי
Knobel	נובל
Barclay	בארקליי
Sadra	סדרא
Coffi	קופי
Mudhafar	מוזפר
Goldblum	גולדבלום
Killen	קילן
Ohara	אוהארא
Zbanic	זבאניטש
Moggi	מודג'י
Kama	קמא
Kyrenia	קיריניא
Mizuno	מיזונו
Guthrie	גאתרי
Morikubo	מוריקובו
Codrea	קודריא
Kirichenko	קיריצ'נקו
Lukashenko	לוקאשינקו
Dodik	דודיק
Reymont	ריימונט
Cahors	קאהור
Charis	קאריס
Greenberg	גרינבירג
Charles	צ'ארלז
Samantha	סאמאנתא
Piszczek	פיזשיק
Klinger	קלינגר
Gharib	גאריב
Irne	אירן
Susic	סוסיטש
Davies	דייביז
Northfield	נורתפילד
Quidde	קויד
Arne	ארני
Jigoro	ג'יגורו
Calder	קאלדר
Nemec	נימיטש
Joseba	ג'וסיבא
Stepanek	סטיפאניק
Edwards	אדוארדז
Boban	בובאן
Neeman	נימאן
Atletico	אטלטיקו
Nalbandian	נאלבאנדיאן
Bellugi	בלוגי
Trinidad	טרינידאד
Severo	סיבירו
Giovanni	ג'ובאני
Larter	לארטר
Grainger	גריינג'ר
Fiedler	פידלר
Hasenclever	האסנקליבר
Khaled	חאלד
Rino	רינו
Konrad	קונראד
Carrasco	קאראסקו
Dileita	דילייטא
Kreuzer	קרוזר
Hino	הינו
Rahmati	ראמאטי
Nino	נינו
Baldur	באלדור
Woese	ווס
Mykonos	מיקונוס
Ruud	רוד
Gino	ג'ינו
Emad	עמאד
Masakiyo	מאסאקיו
Melchiot	מילשיוט
Roehler	רולר
Columba	קולומבא
Bacary	בקארי
Barton	בארטון
Nouadhibou	נואדיבו
Diocletian	דאיאקלישן
Terence	טירינס
Gamliel	גמליאל
Apocalyptica	אפוקאליפטיקא
Suweid	סוייד
Logie	לוגי
Albahri	אלבחרי
Gygax	גיגאקס
Puglisi	פוליזי
Job	ג'וב
Reik	רייק
Indiumiii	אנדיומי
Yukon	יוקון
Roraima	רוראימא
Klimov	קלימוב
Selim	סלים
Matthew	מאתיו
Porter	פורטר
Gonzalo	גונזאלו
Damien	דאמיאן
Helga	הילגא
Lippi	ליפי
Sagna	סאניא
Helge	הילג
Adan	אדן
Ghassan	גסאן
Yukos	יוקוס
Chriqui	שריקי
Clifton	קליפטון
Marketa	מארקיטא
Sese	סיסי
Krychowiak	קריצ'וביאק
Eliakim	אליקים
Dillon	דילון
Dili	דילי
Soleri	סולירי
Mahdi	מהדי
Gili	גילי
Olga	אולגה
Joachim	ג'ואקים
Pasquale	פאסקואלי
Rai	ראי
Chingy	צ'ינגי
Becky	בקי
Vai	ואי
Hendrie	הינדרי
Hai	האי
Stanmore	סטאנמור
Mai	מאי
Bunting	באנטינג
Upchurch	אפצ'ירצ'
Stavanger	סטאבאנג'ר
Prince	פרינס
Bai	באי
Peguy	פיגוי
Dai	דאי
Ploiesti	פלויסטי
Gabriel	גבריאל
Forsskal	פורסקאל
Recife	רסיפי
Paine	פיין
Calleja	קאליכא
Shlaim	שלאים
Phoenix	פיניקס
Norbert	נורברט
Rutland	רוטלאנד
Kinmochi	קינמוצ'י
Reynolds	רינאלדז
Pire	פיר
Malta	מאלטא
Adelman	אדלמאן
Yarkoni	ירקוני
Sultan	סולטאן
Valdez	ואלדיז
Macdowell	מאקדאול
Prolactin	פרולאקטין
Calimero	קאלימירו
Betancourt	ביטאנקורט
Mcclair	מקליר
Phanrit	פאנריט
Dire	דאיר
Fire	פאיר
Gaudi	גאודי
Liebermann	ליברמאן
Postiga	פוסטיגא
Behtash	בהטאש
Pluto	פלוטו
Athletic	אתלטיק
Rioch	ריוצ'
Harry	הארי
Kaltz	קאלץ
Nenad	נינאד
Amalia	אמאליא
Lundgren	לאנדגרין
Anastasia	אנאסטייז'ה
Meciar	מיצ'יאר
Sega	סגא
Dryden	דראידן
Kieron	קירון
Khatami	חאטמי
Farkas	פארקאס
Pedretti	פידריטי
Mcfadden	מקפאדין
Kieran	קיראן
Scatman	סקאטמאן
Torben	טורבין
Teemu	טימו
Brandon	בראנדון
Masayoshi	מאסאיושי
Holland	הולאנד
Heidelberg	האידלברג
Gagarin	גאגארין
Hillingdon	הילינגדון
Berliner	ברלינר
Yasmin	יאסמין
Ghosn	גוסן
Mike	מאיק
Zellweger	זלווגר
Florence	פלורנס
Lucien	לוסיאן
Wilkins	וילקינז
Branson	בראנסון
Queudrue	קודרו
Zachary	זאקארי
Faith	פיית
Gillon	גילון
Slovenia	סלוביניא
Facundo	פאקונדו
Rice	ראיס
Yusuf	יוסוף
Matsuo	מאטסוו
Waddle	ואדל
Bryden	בראידן
Gimelstob	גימלסטוב
Magno	מאגנו
Nice	ניס
Cadherin	קאדהירין
Saint	סיינט
Lamont	לאמונט
Ramla	רמלה
Turku	טורקו
Avalon	אבאלון
Kathy	קאתי
Fillon	פיון
Orlov	אורלוב
Kohl	קול
Castillo	קאסטילו
Nemanja	נימאניא
Munch	מונק
Mimouni	מימוני
Stalteri	סטאלטירי
Kabuki	קאבוקי
Sefer	ספר
Rutan	רוטאן
Shockley	שוקלי
Thorpe	תורפ
Turki	טורקי
Rocheteau	רוצ'יטו
Terrence	טירינס
Montcourt	מונטקורט
Pena	פינא
Rena	רינא
Ebonite	אבונייט
Chris	קריס
Morita	מוריטא
Glynn	גלין
Larry	לארי
Lena	לינה
Orhan	אורהאן
Aissati	עיסאטי
Faustino	פוסטינו
Kirschen	קירשן
Cena	סינא
Slaven	סלאבין
Matza	מצה
Nicephore	ניסיפור
Minoungou	מינונגו
Thessaloniki	תיסאלוניקי
Brukhin	ברוכין
Adolph	אדולף
Diao	דיאו
Triple	טריפל
Yakhour	יאכור
Nedum	נידום
Flynn	פלין
Mistral	מיסטראל
Hanescu	האניסקו
Yehuda	יהודא
Massari	מסארי
Balbo	באלבו
Chamanga	צ'אמאנגא
Shaquille	שאקיל
Hrawi	הראוי
Dagon	דאגון
Segolene	סיגולין
Kaplychnyi	קאפליצ'ני
Walters	ואלטרז
Sima	סימא
Soderberg	סודרבירג
Dragutinovic	דראגוטינובטש
Montgomery	מונטגומרי
Hima	הימא
Banjo	באנג'ו
Peyton	פייטון
Sakaguchi	סאקאגוצ'י
Asparagine	אספאראגין
Doyle	דויל
Dima	דימא
Stiller	סטילר
Gandolfini	גאנדולפיני
Ercolano	ארקולאנו
Ljubicic	ליוביסיטש
Rawhi	ראוחי
Flaherty	פלאהירטי
Tati	טאטי
Courteney	קורטני
Jutland	גו'טלאנד
Bagayoko	באגאיוקו
Ranieri	ראניירי
Jens	ינס
Ferdinando	פרדינאנדו
Silvester	סילבסטר
Jlloyd	ג'לויד
Tal	טאל
Val	ואל
Sviatoslav	סביאטוסלאב
Kal	קאל
Lal	לאל
Redon	רידון
Musharraf	מושארף
Bal	באל
Cal	קאל
Niemoller	נימולר
Mladen	מלאדן
Tancredo	טאנקרידו
Sumer	סומר
Zelaya	זילאיא
Riquelme	ריקילמי
Jelinek	יליניק
Boyle	בויל
Balti	באלטי
Fortuyn	פורטוין
Izhar	איזהאר
Yulia	יוליא
Karpenko	קארפינקו
Pasulko	פאסולקו
Malakouti	מאלאקוטי
Oncken	אונקין
Reto	ריטו
Burdisso	בורדיסו
Rumer	רומר
Dejan	דיג'אן
Rubicon	רוביקון
Merieme	מריאם
Vesely	ויסלי
Leto	ליטו
Prunier	פרונייה
Maine	מיין
Huth	הות
Turnham	טורנהאם
Idaho	אידאהו
Constantinescu	קונסטאנטינסקו
Delic	דיליטש
Osano	אוסאנו
Migueli	מיגוילי
Anders	אנדרז
Bugatti	בוגאטי
Koch	קוך
Loch	לוך
Gernot	גירנו
Korban	קורבן
Cardenosa	קארדינוסא
Shah	שאה
Jop	ג'ופ
Negrila	נגרילא
Wyoming	ויומינג
Ducommun	דוקומון
Sanetomi	סאנטומי
Karren	קארין
Foo	פו
Safra	ספרא
Ferrary	פירארי
Neruda	נירודא
Peri	פרי
Safri	ספרי
Seri	סרי
Yasuhiro	יאסוהירו
Janine	ג'אנין
Mashhur	משהור
Sartawi	סרטאווי
Rotterdam	רוטרדאם
Keri	קירי
Vitaliy	ויטאלי
Melville	מילביל
Neri	נירי
Casanova	קאסאנובא
Camillo	קאמילו
Stubbs	סטאבס
Geza	גזא
Sylvia	סילביא
Williams	ויליאמס
Carre	קארה
Yedid	ידיד
Kissufim	כיסופים
Shiozawa	שיוזאוא
Spelling	ספילינג
Hila	הילה
Suwan	סואן
Lutz	לאץ
Boulahrouz	בולאחרוז
Belarus	בלארוס
Maloney	מאלוני
Pasternak	פאסטרנאק
Kashua	קשוע
Hamburg	האמבורג
Kvasnak	קבאסנאק
Mouath	מועאת
Rowland	רולאנד
Cabrini	קאבריני
Kunihiko	קוניהיקו
Debbas	דבאס
Troshkin	טרושקן
Kebe	קבה
Hadji	חאג'י
Barro	בארו
Yukiko	יוקיקו
Parkour	פארקור
Farman	פארמאן
Livni	ליבני
Marwahin	מרווחין
Barry	בארי
Heyerdahl	האירדאל
Chansa	צ'אנסא
Brehme	ברימה
Sargsyan	סרגסיאן
Connelly	קונילי
Lucky	לאקי
Melhem	מלחם
Ireland	אירלנדא
Bancarel	באנקאריל
Artur	ארטור
Zukerman	זקרמאן
Cleveland	קליבלאנד
Devall	דיבאל
Fathi	פתחי
Eido	עידו
Strait	סטרייט
Sadeq	סאדק
Ibrahim	איבראהים
Sohrab	סוהראב
Montella	מונטילא
Gershwin	גירשוין
Fathy	פתחי
Patricio	פאטריסיו
Xtra	אקסטרא
Zeidan	זיידאן
Tusun	טוסון
Jasseron	ג'אסירון
Dusseldorf	דוסלדורף
Hanson	האנסון
Felix	פיליקס
Jackman	ג'אקמאן
Yakovlev	יאקובליב
Navratilova	נאבראטילובא
Tikva	תקוה
Hansen	האנסן
Qasr	קסר
Menzo	מינזו
Garry	גארי
Tibi	טיבי
Allah	אללה
Zoff	זוף
Allan	אלאן
Kaviedes	קאבידס
Allal	עלאל
Piccadilly	פיקאדילי
Greco	גריקו
Kieft	קיפט
Bibi	ביבי
Yao	יאו
Rachad	ראצ'אד
Hartfield	הארטפילד
Karnei	קארניי
Ulihrach	יוליהראטש
Kristian	קריסטיאן
Boujelbene	בוג'לבאן
Ralph	ראלף
Rachid	רשיד
Medawar	מדוור
Muin	מועין
Hao	האו
Avtovaz	אבטובאז
Barbados	בארבאדוס
Pantanal	פאנטאנאל
Fanous	פאנוס
Mao	מאו
Grondona	גרנדונא
Freddy	פרידי
Leyton	לייטון
Enos	אינוס
Cao	קאו
Dao	דאו
Pink	פינק
Alberto	אלברטו
Belgrade	בלגראד
Vink	וינק
Yelchin	ילצ'ין
Manmohan	מאנמוהאן
Gizenga	גיזינגא
Zamrak	זמרק
Crvenkovski	קרבינקובסקי
Harb	חארב
Malkin	מאלקין
Kanaan	כנען
Ridgewell	רידג'וול
Rincon	רינקון
Sarrionandia	סאריונאנדיא
Marcian	מארקיאן
Fulton	פולטון
Honda	הונדא
Cavell	קאביל
Manson	מאנסון
Brunelleschi	ברונליסקי
Saadi	סעדי
Izmir	איזמיר
Halilhodzic	חלילהודזיטש
Radoslav	ראדוסלאב
Tainio	טאיניו
Surtees	סורטיס
Schachner	שאצ'נר
Khamees	חמיס
Schwartzman	שוארmמן
Netolicka	ניטוליקא
Delhi	דלהי
Katalinski	קאטאלינסקי
Shobair	שובייר
Gerrard	ג'רארד
Daibes	דעיבס
Norilsk	נורילסק
Moratti	מוראטי
Oulmou	אולמו
Alikhani	עליחאני
Tugendhat	טוגנדהאט
Hermesh	חרמיש
Mr.	מיסטר
Hilu	חילו
Elsanhuri	אלסנהורי
Petre	פיטרי
Vermont	ורמונט
Beatrice	ביאטריס
Nostradamus	נוסטראדאמוס
Heydar	חאידר
Asamoah	אסאמוא
Kowloon	קאולון
Armin	ארמין
Heurelho	הורילהו
Agrippa	אגריפא
Schwarzer	שוארצר
Sapunaru	סאפונארו
Hart	הארט
Kowalewski	קואלוסקי
Zarate	זאראט
Meshir	משיר
Koyamada	קויאמאדא
Carole	קארול
Remez	רמז
Bart	בארט
Deleuze	דלוז
Monde	מונד
Camataru	קאמאטארו
Westminster	וסטמינסטר
Nuur	נור
Theerawesin	תיראווסין
Hakikar	האקיקאר
Sylvite	סילביט
Freleng	פרילינג
Robert	רוברט
Jansen	יאנסן
Meazza	מיאצא
Harper	הארפר
Ajab	עג'ב
Thiering	תירינג
Shamkhani	שאמכאני
Totti	טוטי
Conny	קוני
Ndadaye	נדאדאי
Sulim	סולים
Zvonareva	זבונאריבא
Nitza	ניצה
Hokkaido	הוקאידו
Vahidin	ואהידין
Perelman	פרלמאן
Demetrio	דימיטריו
Isabelle	איזאבל
Kondo	קונדו
Chandler	צ'אנדלר
Schiffer	שיפר
Stephane	סטיפאן
Gascoigne	גאסקוין
Rexhep	רג'פ
Detroit	דיטרויט
Reda	רדא
Kasyanov	קאסיאנוב
Meyrieu	מיריו
Cagliari	קאליארי
Nernst	נרנסט
Nuwas	נוואס
Baal	בעל
Neda	נדא
Beda	בידא
Tokelau	טוקילאו
Heraklion	היראקליון
Abdulaziz	עבדולעזיז
Takanori	טאקאנורי
Cristian	קריסטיאן
Mingyu	מינגיו
Nansen	נאנסן
Dalmatia	דאלמיישא
Cipollini	צ'יפוליני
Jessica	ג'סיקא
Recoba	ריקובא
Southampton	סאותהאמפטון
Sirkin	סירקן
Wiland	וילאנד
Figo	פיגו
Mardi	מארדי
Stalling	סטאלינג
Tomaso	טומאסו
Schuttler	שוטלר
Shiningayamwe	שינינגאיאמוי
Verona	וירונא
Zaccardo	זקארדו
Sidibe	סידיבי
Pickett	פיקיט
Yamani	ימאני
Paphlagonia	פאפלאגוניא
Valeriy	ואלירי
Radcliffe	ראדקליף
Hairuddin	האירודין
Rica	ריקא
Dearborn	דירבורן
Lambert	לאמבירט
Dyab	דיאב
Tugce	טוג'י
Feist	פיסט
Kublai	קובלאי
Megiddo	מגידו
Verheyen	וירהיין
Seeldrayers	סילדראירס
Munoz	מונוז
Cairo	קאירו
Zaragoza	זאראגוזא
Gabriele	גאבריאל
Dica	דיקא
Marino	מארינו
Albanian	אלבייניאן
Rudyard	רדיארד
Moncayo	מונקאיו
Nonda	נונדא
Fusako	פוסאקו
Ryoji	ריוגصי
Rinko	רינקו
Lichtsteiner	ליכטסטיינר
Miura	מיורא
Daisuke	דאיסוק
Dyer	דאיר
Yashin	יאשין
Ramn	ראמן
Taffarel	טאפאריל
Lugano	לוגאנו
Ivanovic	איבאנוביטש
Ataturk	אטאטורק
Romano	רומאנו
Viv	ויו
Balkan	בלקאן
Moravcik	מוראבצ'יק
Malaga	מאלאגא
Liv	ליב
Risser	ריסר
Niv	ניב
Taub	טאוב
Meriah	מריאח
Mauritania	מוריטייניא
Brik	בריק
Timlin	טימלין
Granqvist	גראנקביסט
Nishimura	נישימורא
Shoval	שובל
Jammeh	ג'אמע
Mombasa	מומבאסא
Southend	סאותאנד
Simeon	סימיאן
Tandon	טאנדון
Ifeanyi	איפאניי
Hammadi	חמאדי
Shevardnadze	שיברדנאדזה
Jermaine	ג'רמיין
Lance	לאנס
Harlem	הארלם
Lagerkvist	לאגרקביסט
Libby	ליבי
Bakhit	בכיט
Mircea	מירסיא
Motta	מוטא
Hayami	האיאמי
Lagerback	לאגרבאק
Brunner	ברונר
Colfax	קולפאקס
Arshavin	ארשאבין
Sambora	סאמבורא
Gentile	ג'נטילי
Katsura	קאצורא
Fleischer	פלאישר
Gajdůsek	גאידוסיק
Geoffrey	ג'פרי
Westinghouse	וסטינגהאוס
Trentino	טרינטינו
Joshua	ג'ושוא
Almurshid	אלמורשיד
Lotte	לוט
Yaqub	יעקוב
Luciano	לוסיאנו
Velasquez	וילאסקיז
Hendrik	הנדריק
Oppenheimer	אופנהימר
Manolete	מאנוליטי
Turner	טירנר
Sarah	סארה
Zuhr	זוהר
Richter	רישטר
Muzinic	מוזיניטש
Pflugler	פפלוגלר
Mndez	מנדיז
Janusz	יאנוש
Yaqut	יאקוט
Belaya	בילאיא
Nestorius	נסטוריוס
Darko	דארקו
Muwanga	מוואנגא
Julio	יוליו
Boakye	בואקיה
Hany	האני
Hofmann	הופמאן
Mitsumasa	מיטסומאסא
Olimpia	אולימפיא
Julia	ג'וליא
Shevchenko	שבצ'נקו
Mainz	מיינז
Stresemann	סטריסמאן
Knud	נוד
Riemann	רימאן
Kalman	קאלמאן
Ramayana	ראמאיאנא
Iraola	איראולא
Steve	סטיב
Theropoda	תירופודא
Guerreiro	גוירירו
Mey	מיי
Ney	ניי
Saratov	סאראטוב
Dubinski	דובינסקי
Bey	ביי
Hammill	האמל
Dey	דיי
Lima	לימא
Fey	פיי
Mcneil	מקניל
Lidice	לידיס
Sharett	שאריט
Wawrinka	ואורינקא
Dmitry	דמיטרי
Nanbudo	נאנבודו
Gdansk	גדאנסק
Ronaldo	רונאלדו
Moglen	מוגלין
Ouarzazate	ורזאזאת
Bergson	ברגסון
Katowice	קאטויסא
Rissos	ריסוס
Ronaldinho	רונאלדינהו
Faulkner	פולקנר
Gesher	גשר
Nadine	ניידין
Hellenic	היליניק
Mega	מגא
Fromm	פרום
Mazzola	מאצולא
Madrid	מדריד
Fadl	פאדל
Gerizim	גריזים
Bergomi	בירגומי
Stahl	סטאל
Arjun	ארג'ון
Simas	סימאס
Komano	קומאנו
Baabda	בעבדא
Amartya	אמארטיא
Piotr	פיוטר
Sabeer	סאביר
Plaatjies	פלאטג'יס
Bangladesh	בנגלאדש
Yobo	יובו
Soddy	סודי
Fonda	פונדא
Medvedev	מידבידיב
Deutsche	דוטש
Breen	ברין
Skalski	סקאלסקי
Maggie	מאגי
Jackson	ג'אקסון
Ricardinho	ריקארדינהו
Yorke	יורק
Malbranque	מאלבראנק
Alloudi	עלודי
Vito	ויטו
Thompson	טומסון
Taarabt	טאראבט
Neill	ניל
Bassel	באסל
Pauline	פולין
Ciolek	קיוליק
Roddy	רודי
Zuckmayer	צוקמאיר
Roitman	רויטמאן
Takeo	טאקיו
Iaquinta	איאקוינטא
Citroen	סיטרואן
Bugalo	בוגאלו
Fizeau	פיזו
Marat	מאראט
Terzanidis	טירזאנידיס
Tekle	טקלה
Pyotr	פיוטר
Ilan	אילן
Khader	חאדר
Ndikumana	נדיקומאנא
Hazem	חאזם
Hiroshima	הירושימא
Rockwell	רוקוול
Hiroki	הירוקי
Selway	סילויי
Enric	אנריק
Quzman	קוזמאן
Ernst	ארנסט
Sfax	ספאקס
Still	סטיל
Teng	טנג
Zaydun	זיידון
Shams	שאמס
Dimitri	דימיטרי
Margarete	מארגרט
Luisao	לויסאו
Turing	טורינג
Peretz	פרץ
Weinek	ויניק
Sukhumi	סוכומי
Zviad	זביאד
Deng	דינג
Feng	פנג
Ramdane	רמדאן
Pilguy	פילגוי
Hamm	האם
Ferhat	פרחאט
Vialli	ויאלי
Guojohnsen	גוג'ונסון
Jashari	ישארי
Sacchi	סאקי
Efraim	אפרים
Potito	פוטיטו
Boulus	בולוס
Saddam	סדאם
Karan	קאראן
Botta	בוטא
Morientes	מוריאנטס
Coppell	קופל
Pradesh	פראדיש
Carbonic	קרבוניק
Magalhaes	מאגאלהאיז
Podgorica	פודגוריקא
Salomaa	סאלומא
Danube	דאנוב
Plata	פלאטא
Gattuso	גאטוסו
Mohammad	מוחמד
Kansas	קאנסאס
Camelot	קאמלוט
Jorg	ג'ורג
Shawky	שוקי
Oracle	אוראקל
Sanz	סאנז
Tenerife	טנריף
Hidegkuti	הידיקוטי
Kremer	קרימר
Marcello	מארצ'לו
Pereira	פיריירא
Maryland	מארילאנד
Bahram	בהראם
Franklyn	פראנקלין
Braxton	בראקסטון
Catherine	קאתירין
Metreveli	מיטריבילי
Ambrose	אמברוס
Caine	קיין
Makram	מקרם
Lato	לאטו
Midori	מידורי
Geagea	געגע
Popa	פופא
Carniglia	קארניגליא
Matsuda	מאטסודא
Temsamani	טמסמאני
Bangkok	באנקוק
Pyongyang	פיונגיאנג
Lipchitz	ליפשיץ
Latuff	לאטוף
Kopa	קופא
Hester	הסטר
Dulaim	דוליים
Copa	קופא
Montmartre	מונטמארטר
Micheľ	מיכיל
Cleary	קלירי
Skarmeta	סקארמיטא
Saborio	סאבוריו
Liaoning	לאיונינג
Satoru	סאטורו
Susilo	סוסילו
Delbruck	דלברוק
Galliani	גאליאני
Jacobson	ג'אקובסון
Sarayoot	סאראיוט
Pairetto	פאיריטו
Moretti	מוריטי
Stefani	סטיפאני
Herzl	הרצל
Entebbe	אנטבה
Cavanna	קאבאנא
Ghayeghran	גאיגראן
Kamiya	קאמיא
Solari	סולארי
Ibiza	איביזא
Haddock	האדוק
Langer	לאנגר
Palop	פאלופ
Bjorn	ביורן
Allianz	אליאנז
Cusack	קוזאק
Renner	רינר
Johanna	יוהנא
Bassi	באסי
Ilia	איליא
Seehawong	סיהאוונג
Beye	בייה
Shaobo	שאובו
Villegas	ויליגאס
Godfrey	גודפרי
Ellison	אליסון
Sukristov	סוקריסטוב
Daraa	דרעא
Mukasey	מוקייזי
Goodyear	גודייר
Jedina	ג'דינא
Shaarawi	שעראוי
Rudd	רוד
Judd	ג'אד
Marchena	מארצ'ינא
Hojo	הוג'ו
Cattermole	קאטרמול
Haaretz	הארץ
Grass	גראס
Burgnich	בורגניטש
Huygens	הוגינס
Aflaq	עפלק
Maurizio	מוריזיו
Yosuke	יוסוקה
Rem	רים
Avni	אבני
Heidi	האידי
Malick	מאליק
Lem	לם
Bolzano	בולזאנו
Huchel	הוכל
Melvin	מלווין
Yakan	יקן
Bem	בם
Hillary	הילארי
Rigobert	ריגוברט
Hikaru	היקארו
Geffen	גפן
Arun	ארון
Baram	באראם
Moldovan	מולדובאן
Nana	נאנא
Grun	גרון
Barak	ברק
Cremer	קרימר
Sumatra	סומטרה
Yamin	ימין
Felicia	פילישא
Niflheim	ניפלהאים
Modeste	מודיסטי
Waske	ואסקי
Bejbl	בייבל
Sushi	סושי
Osman	עוסמאן
Niclas	ניקלאס
Popescu	פופיסקו
Degania	דגניה
La	לא
Vercingetorix	ורסינגיטוריקס
Hobart	הובארט
Azmi	עזמי
Ba	בא
Cesaire	סיזיר
Lil	ליל
Mika	מיקא
Oil	אויל
Mohajerani	מוהאג'ראני
Yellowstone	ילוסטון
Gil	גיל
Daudet	דודה
Devouard	דיבואר
Vojta	בויטא
Albari	אלבארי
Gwen	גוין
Simunic	סימוניטש
Lillehammer	לילהאמר
Jerzy	יירזי
Premysl	פרימסל
Galsworthy	גאלזוורתי
Hidalgo	הידאלגו
Baresi	באריזי
Ababa	אבאבא
Parma	פארמא
Adriana	אדריאנא
Mauss	מאוס
Sangweni	סאנגויני
Rousset	רוסיט
Haney	הייני
Vermes	ורמס
Socha	סוכא
Fazekas	פאזיקאס
Garay	גאראי
Naor	נאור
Yumiko	יומיקו
Edvard	אדבארד
Kittisak	קיטיסאק
Dietz	דיץ
Carney	קארני
Miran	מיראן
Zenko	זינקו
Sheringham	שירנגהאם
Doug	דוג
Farah	פארח
Faraj	פרג'
Sahar	סחר
Lilian	ליליאן
Jeffrey	ג'פרי
Fortune	פורטשן
Agatha	אגאתא
Roche	רוש
Watts	ואטס
Toronto	טורונטו
Bucharest	בוכארסט
Toulouse	טולוז
Farag	פאראג
Mahmud	מחמוד
Sahab	סחאב
Donitz	דוניץ
Godwinson	גודוינסון
Mazinho	מאזינהו
Sar	סר
Saxony	סאקסוני
Giuseppe	ג'וזיפי
Nilsson	נילסון
Prodl	פרודל
Sharpe	שארפ
Lamari	לאמארי
Khoren	חורין
Gould	גולד
Takahara	טאקאהארא
Mikkel	מיקל
Cassandra	קאסאנדרא
Christanval	קריסטאנבאל
Rosa	רוזא
Hermann	הירמאן
Babacan	באבאקאן
Podesta	פודיסטא
Vizek	ויזיק
Kiran	קיראן
Jenner	ג'נר
Holcer	הולקר
Hanegbi	הנגבי
Bondarenko	בונדארינקו
Nadia	נאדיא
Kaplan	קפלאן
Cliff	קליף
Hochu	הוצ'ו
Lazarev	לאזאריב
Bartolucci	בארטולוצ'י
Ritchie	ריצ'י
Manet	מאנה
Pompeu	פומפיו
Seif	סיף
Ruggiero	רוגיירו
Hudgens	האדג'נז
Akihito	אקיהיטו
Leif	ליף
Corzine	קורזאין
Benhassi	בנחסי
Alhamadi	אלחמאדי
Starace	סטאראסי
Manea	מאניע
Zachariah	זאכאראיא
Vukotic	ווקוטיטש
Claudia	קלאודיא
Yuichi	יויצ'י
Elachi	אלעשי
Maqam	מקאם
Ladovsky	לאדוביסקי
Ludovico	לודוביקו
Sumner	סאמנר
Bonaire	בונייר
Giorgos	ג'יורגוס
Lemasson	למאסון
Beenhakker	בינהאקר
Tenorio	טינוריו
Tatum	טאטום
Kleiber	קליבר
Clijsters	קלאיסטרז
Efron	אפרון
Hajim	חאג'ים
Schumpeter	שומפיטר
Saiwaeo	סאיוואו
Ross	רוס
Mahrous	מחרוס
Porphyria	פורפיריא
Minix	מיניקס
Asti	אסטי
Bassila	באסילא
Belozoglu	בילוזוגלו
Mattawa	מטאוע
Moss	מוס
Malot	מאלו
Carpinello	קרפינילו
Goor	גור
Demba	דימבא
Huesca	הואסקא
Sharir	שריר
Stephenson	סטיפנסן
Demeter	דימיטר
Migron	מיגרון
Shayne	שיין
Mokhtari	מוחטארי
Sophia	סופיא
Janez	ג'אניז
Legrottaglie	ליגרוטאלי
Satoshi	סאטושי
Unesco	יוניסקו
Moog	מוג
Grenet	גריניט
Matsuoka	מאטסוקא
Yanai	ינאי
Regueiro	ריגיירו
Tyrosine	טירוסין
Shukeiri	שוקיירי
Moseley	מוזלי
Stif	סטיף
Kazimir	קאזימיר
Dianne	דאיאן
Chovanec	צ'ובאניטש
Mikel	מיקל
Tsuyoshi	טסויושי
Stern	סטירן
Oswald	אוסואלד
Advocaat	אדבוקאט
Muller	מולר
Mahal	מחל
Kalou	קאלו
Mariano	מאריאנו
Raldes	ראלדיס
Mirbeau	מירבו
Halley	האלי
Soseki	סוסיקי
Rio	ריו
Belqas	בלקאס
State	סטייט
Mordor	מורדור
Australia	אוסטראליא
Elhanan	אלחנן
Dailly	דיילי
Lahad	לחד
Abboud	עבוד
Leningrad	לינינגראד
Nambaryn	נאמבארין
Musemic	מוסימיטש
Veliko	וליקו
Wole	וול
Lakshmi	לאקשמי
Imlay	אימליי
Hurndall	הרנדל
Rednic	רידניק
Cole	קול
Jochi	ג'וטשי
Rosicky	רוסיקי
Collin	קולן
Bruno	ברונו
Teymourian	טיימוריאן
Bruni	ברוני
Menezes	מיניזיס
Ryokichi	ריוקיצ'י
Dudley	דאדלי
Harewood	האריווד
Lammens	לאמנס
Horie	הורי
Montero	מונטירו
Foreman	פורמאן
Kuntar	קונטאר
Steiner	סטיاנר
West	ווסט
Mcmahon	מקמאהון
Ludza	לודזא
Sardinia	סרדיניא
Jahan	ג'האן
Zoetermeer	זויטרמיר
Tillman	טילמאן
Aloni	אלוני
Hyundai	היונדאי
Kargus	קארגוס
Birak	ביראק
Houghton	הוטון
Chantal	שאנטאל
Teerasil	טיראסיל
Baer	באיר
Tojo	טוג'ו
Masaru	מאסארו
Emerich	אימיריך
Rene	רנה
Hori	הורי
Tamim	תמים
Kotler	קוטלר
Shelley	שלי
Louisiana	לויזיאנא
Spence	ספינס
Levy	לוי
Matus	מאטוס
Paston	פאסטון
Raed	ראאד
Ilya	איליא
Nixon	ניקסון
Valdis	ואלדיס
Danes	דיינס
Moctezuma	מוקטיזומא
Gene	ג'ין
Khamis	חמיס
Nanninga	נאנינגא
Valdas	ואלדאס
Milenko	מילנקו
Krueger	קרוגר
Valdes	ואלדז
Viacheslav	ויאשיסלאב
Bernoulli	בירנולי
Samih	סמיח
Warner	וארנר
Nicolet	ניקולה
Baghdad	בגדאד
Rym	רים
Magomedov	מאגומידוב
Ruth	רות
Akaki	אקאקי
Handke	האנדקה
Mili	מילי
Nili	נילי
Nicola	ניקולא
Hellman	הילמאן
Avivim	אביבים
Karmi	כרמי
Yaounde	יאונדי
Nahal	נחל
Ramin	ראמין
Jahsh	ג'חש
Tartus	טרטוס
Mantell	מאנטל
Songul	סונגול
Banel	באניל
Iskandar	איסקנדר
Heisserer	הייסרר
Boleyn	בולין
Hines	האינז
Surprise	סירפראיס
Wilander	וילנדר
Hertz	הרץ
Soldado	סולדאדו
Sealy	סילי
Muhammadu	מוחמדו
Seale	סיל
Kinkel	קינקל
Bradbury	בראדברי
Hakan	האקאן
Wijnstekers	וינסטיקירז
Fechner	פכנר
Latins	לאטינז
Hamit	חמיט
Dahab	דהב
Mizrahi	מזרחי
Firas	פיראס
Nielsen	נילסן
Corrigan	קוריגאן
Dragila	דראגילא
Sira	סירה
Peluce	פלוס
Lopez	לופז
Rupert	רופרט
Hamid	חמיד
Krol	קרול
Ballesta	באייסטא
Bonsai	בונסאי
Djokovic	דג'וקוביטש
Gotthelf	גוטהילף
Mytilene	מיטילין
Murtala	מורטאלא
Marconi	מארקוני
Nebraska	נבראסקא
Piscator	פיסקאטור
Delaney	דילייני
Dominica	דומיניקא
Free	פרי
Hoffman	הופמאן
Sarkozy	סארקוזי
Ganea	גאניא
Veissire	וייסיר
Karolos	קארולוס
Tierney	טירני
Toru	טורו
Buganda	בוגאנדא
Conakry	קונאקרי
Asher	אשר
Chokheli	צ'וכילי
Kinnock	קינוק
Badalona	באדאלונא
Hamidou	חמידו
Bikey	באיקי
Taheyya	טחיה
Bahar	בחר
Lavoisier	לאבואזייה
Titus	טאיטוס
Calcutta	קאלקוטא
Suttner	סוטנר
Shalit	שליט
Johnston	ג'ונסטון
Binyamin	בנימין
Lisandro	ליסאנדרו
Zetkin	זטקין
Massad	מסעד
Sayaka	סאיאקא
Sadek	סאדק
Libre	ליבר
Mcguinness	מאקגינס
Akrour	עקרור
Skacel	סקאסל
Sculli	סקולי
Talfah	טלפאח
Lillian	ליליאן
Qanso	קאנסו
Vermelhinho	ורמילהינו
Lupe	לופ
Hydrographic	האידרוגראפיק
Bauhaus	באוהאוס
Guevara	גווארא
Getulio	גיטוליו
Jay	ג'יי
Montenegro	מונטיניגרו
Jacqueline	ג'אקלין
Derrida	דרידא
Ravshan	ראבשאן
Tolstoy	טולסטוי
Radek	ראדיק
Kosuke	קוסוקי
Huxley	האקסלי
Kitazawa	קיטאזאוא
Plasil	פלאסיל
Waleed	וליד
Gerd	גרד
Berkley	בירקלי
Lamia	לאמיא
Benenson	ביניסון
Carrasso	קאראסו
Shepard	שיפארד
Houssay	הוסאי
Tuscany	טוסקאני
Navarro	נאבארו
Corver	קורבר
Piroxicam	פירוקסיקאם
Noam	נועם
Hancock	האנקוק
Thom	טום
Kamil	קאמל
Dooley	דולי
Helmut	הלמוט
Orleans	אורלינז
Holmboe	הולמבוי
Marciano	מארסיאנו
Phillips	פיליפס
Phau	פאו
Kolodin	קולודין
Avraham	אברהם
Gunter	גונטר
Dwomoh	דוומוה
Haden	היידן
Phnom	פנום
Custers	קוסטרס
Mihai	מיהאי
Geronimo	ג'ראנימו
Abraham	אברהם
Dawood	דאוד
Fuller	פולר
Julie	ג'ולי
Grillon	גרילון
Doria	דוריא
Kirchner	קירשניר
Dawoud	דאוד
Jamie	ג'יימי
Sanaa	סאנא
Hershko	הירשקו
Grace	גרייס
Como	קומו
Menashe	מנשה
Jankulovski	יאנקולובסקי
Hubert	היוברט
Rosato	רוזאטו
Kavazashvili	קאבאזאשבלי
Krutikov	קרוטיקוב
Sulayman	סלימאן
Kaneto	קאניטו
Friz	פריז
Praseodymium	פראסיודימיום
Mitch	מיטש
Cuza	קוזא
Zakat	זקאת
Devendra	דיבינדרא
Sulaiman	סוליימן
Odense	אודנסי
Peel	פיל
Camden	קאמדן
Dzodzuashvili	דזודזואשבילי
Peruzzi	פירוצי
Mart	מארט
Nakai	נאקאי
Dionysius	דיוניסיוס
Roussos	רוסוס
Lupolianski	לופוליאנסקי
Oslo	אוסלו
Nakao	נאקאו
Taylor	טיילור
Koki	קוקי
Shepherd	שיפארד
Blazej	בלאזיי
Abane	עבאן
Miyake	מיאקי
Namie	נאמי
Kaizen	קאיזן
Bourbaki	בורבאקי
Stefan	סטיפאן
Jihai	ג'יהאי
Jihad	ג'יהאד
Haile	האילי
Primus	פראימוס
Sbarro	סבארו
Babayaro	באבאיארו
Sean	שון
Happel	האפל
Sandra	סאנדרא
Hanan	חנאן
Quaresma	קואריסמא
Ashley	אשלי
Jean	ג'ין
Takayoshi	טאקאיושי
Lean	לין
Zeezee	זיזי
Pasha	פאשא
Duffy	דאפי
Mohammadou	מוחמדו
Yoshimoto	יושימוטו
Wynalda	וינאלדא
Dean	דין
Benko	בינקו
Nadal	נאדאל
Gensho	גינשו
Kalavryta	קאלאבריטא
Mercury	מירקורי
Palikir	פאליקיר
Vasyl	ואסיל
Jardel	ג'ארדל
William	ויליאם
Nadav	נדב
Azizou	עזיזו
Heyligen	היליגין
Krakow	קראקו
Alexandru	אלקסנדרו
Zorin	זורין
Parreira	פארירא
Kuka	קוקא
Kader	קאדר
Simin	סימין
Saxton	סאקסטון
Santorini	סאנטוריני
Bois	בווא
Nathaniel	נאתאניאל
Youga	יוגא
Causio	קאוזיו
Alexandre	אלקסנדר
Ramadan	רמדאן
Graeme	גראם
Damir	דמיר
Tate	טייט
Marcin	מארצן
Piontek	פיונטיק
Billie	בילי
Soyuz	סויוז
Kate	קייט
Mate	מאטי
Seville	סיביל
Nihat	ניהאט
Cate	קאטי
Siirt	סירט
Kumbh	קומב
Momcilo	מומסילו
Kjeld	קילד
Binet	בינה
Yoichiro	יויצ'ירו
Hansi	האנסי
Barbera	בארבירא
Takano	טאקאנו
Kenenisa	קיניניסא
Awad	עוואד
Berto	בירטו
Luanda	לואנדא
Daiki	דאיקי
Alberta	אלברטא
Bakar	בקר
Torelli	טורילי
Emek	עמק
Stan	סטאן
Pozo	פוזו
Hamouche	חמוש
Zouagi	זואגי
Ravin	ראבין
Casablanca	קאסאבלאנקא
Zuse	זוס
Insulin	אינסולין
Lepiller	ליפיליר
Maresca	מאריסקא
Vidinic	וידיניטש
Bamir	באמיר
Ankara	אנקרה
Dortmund	דורטמונד
Keira	קירא
Paro	פארו
Daoudi	אלדאודי
Cronenberg	קרוננברג
Taro	טארו
Mental	מינטאל
Minh	מין
Balmont	באלמונט
Djvu	דג'בו
Karo	קארו
Konstantinou	קונסטאנטינו
Valke	ואלק
Chasseriau	קאסיריו
Rageh	ראגח
Caro	קארו
Aamir	עאמיר
Sambusac	סמבוסק
County	קאונטי
Spyri	שפירי
Fifa	פיפא
Malko	מאלקו
Nurhaliza	נורהאליזה
Mamoru	מאמורו
Abadan	עבדאן
Nader	ניידר
Butenandt	בוטינאנט
Malaysia	מאלייז'א
Tamada	טאמאדא
Hamoud	חמוד
Monterrey	מונטיריי
Song	סונג
Tong	טונג
Dedekind	דידיקינד
Hong	הונג
Glenda	גלינדא
Shiba	שיבא
Nikoloudis	ניקולודיס
Long	לונג
Gerty	גרטי
Yossi	יוסי
Mahmudi	מחמודי
Gamil	גמיל
Hagen	האגן
Dong	דונג
Blatter	בלאטר
Plamen	פליימן
Gong	גונג
Afghani	אפגאני
Marshall	מארשאל
Georgios	גיורגיוס
Euclid	יוקליד
Quinto	קוינטו
Samaha	סמאחה
Andresen	אנדרסן
Moradi	מוראדי
Linz	לינז
Rothschild	רותשילד
Neira	ניירא
Rubinstein	רובינסטין
Tibor	טיבור
Basten	באסטן
Mccann	מקאן
Marmaduke	מארמאדוק
Badilla	באדילא
Hertzberger	הירצברגר
Renzo	רינזו
Gavras	גאבראס
Zola	זולא
Mexes	מקסיס
Ravousis	ראבוסיס
Gaarder	גארדר
Muriel	מוריאל
Olsson	אולסן
Saba	סאבא
Dickov	דיקוב
Lola	לולא
Nordisk	נורדיסק
Darren	דארין
Murasaki	מוראסאקי
Bola	בולא
Euterpe	יוטירפי
Pistone	פיסטוני
Roni	רוני
Johnny	ג'וני
Toni	טוני
Dietmar	דיטמאר
Heshmat	חשמט
Sorin	סורין
Hathairattanakool	האתאיראטאנאקול
Oday	עודאי
Zengin	זינגן
Ribot	ריבו
Acutifolia	אקיוטיפוליא
Naseem	נאסים
Placente	פלאסנטי
Enfield	אנפילד
Menasse	מינאסה
Bader	באדר
Cristiano	קריסטיאנו
Mendelsohn	מנדלסון
Hiden	הידן
Hideo	הידיו
Henze	הינז
Hanania	חנאניא
Borobudur	בורובודור
Chislenko	צ'יסלנקו
Palermo	פאלרמו
Okamoto	אוקאמוטו
Aristizabal	אריסטיזאבאל
Hulusi	חולוסי
Cinderella	סינדרילא
Balaban	באלאבאן
Stuart	סטיוארט
Jasmila	יאסמילא
Shaukat	שאוקאט
Menshevik	מנשביק
White	ואיט
Cabot	קאבוט
Akhmeteli	אכמיטילי
Sinan	סינאן
Gaston	גאסטון
Sudoku	סודוקו
Klasnic	קלאסניטש
Rinat	רינת
Barron	בארון
Mattias	מאטיאס
Nyquist	נאיקסט
Piaf	פיאף
Costanzo	קוסטאנזו
Lipstadt	ליפסטדאט
Alegre	אליגרי
Borges	בורכיס
Springer	ספרינגר
Ethology	אתולוג'י
Karloff	קארלוף
Decius	דקיוס
Diop	דיופ
Souleymane	סולימאן
Mingyi	מינגי
Rouani	רואני
Bernard	ברנאר
Hrant	הראנט
Campos	קאמפוס
Pagnol	פאניול
Timoshenko	טימושינקו
Manuela	מאנואלא
Sharon	שרון
Umm	אום
Kiwus	קיווס
Raducioiu	ראדוסיו
Chavez	צ'אביז
Laryea	לאריא
Taim	טאים
Kiev	קייב
Radon	ריידון
Haim	חיים
Dardenne	דארדין
Fadel	פאדל
Adir	אדיר
Mundell	מאנדל
Vistula	ויסטולא
Đorđevic	דורדיביטש
Beernaert	בירנארט
Haase	האסי
Castonier	קאסטוניר
Morrison	מוריסון
Rotson	רוטסון
Mitnick	מיטניק
Mishima	מישימא
Kaku	קאקו
Takamori	טאקאמורי
Kyzyl	קיזיל
Baku	באקו
Ripley	ריפלי
Piturat	פיטוראט
Ri	רי
Si	סאי
Baba	באבא
Hiro	הירו
Palin	פאלין
Antonino	אנטונינו
Kamara	קאמארא
Guido	גוידו
Morin	מורין
Klaus	קלאוס
Feldman	פלדמאן
Gabor	גאבור
Russel	ראסל
Rivoli	ריבולי
Oregon	אוריגון
Jorge	ג'ורג'
Rozehnal	רוזיהנאל
Vasily	ואסילי
Morgenstern	מורגנסטירן
Suker	סוקר
Navarre	נאבאר
Wilkinson	וילקנסן
Ciesla	סיסלא
Castano	קאסטאנו
Budyanskiy	בודיאניסקי
Shehab	שהאב
Cornell	קורניל
Mchugh	מיקהיו
Halldor	האלדור
Lampard	לאמפארד
Puskas	פוסקאס
Greiss	גריס
Minar	מינאר
Bezalel	בזלאל
Zoco	זוקו
Donadoni	דונאדוני
Sikorsky	סיקורסקי
Plutarch	פלוטארך
Barghouti	ברגותי
Daughtry	דוטרי
Theodosius	תיודוסיוס
Mandriva	מאנדריבא
Masi	מאסי
Dior	דיור
Alvin	אלווין
Nezami	נזאמי
Loco	לוקו
Davis	דייויס
Kiryat	קרית
Djalma	ג'אלמא
Boco	בוקו
Coco	קוקו
Vishnu	וישנו
Gustav	גוסטאב
Stacy	סטייסי
Shatskikh	שאצקיך
Coty	קוטי
Sagnol	סאניול
Diaz	דיאז
Papetti	פאפיטי
Joris	יוריס
Linn	לין
Soichiro	סויצ'ירו
Siegfried	סיגפריד
Xuri	קסורי
Yuri	יורי
Ghulam	גולאם
Geldof	גילדוף
Buchholz	בוכהולץ
Ars	ארס
Mahdoufi	מחתופי
Qassem	קאסם
Kinan	קנאן
Bernhard	ברנהארד
Subait	סוביט
Corelli	קורילי
Mourinho	מורינהו
Milka	מילקא
Streisand	סטראיסאנד
Khashoggi	חאשוגי
Christian	קריסטיאן
Haßler	האסלר
Scandinavia	סקאנדינאביא
Baran	באראן
Camilo	קאמילו
Venizelos	וניזילוס
Shania	שאניא
Jovian	ג'וביאן
Parkinson	פארקינסון
Salim	סלים
Marcell	מארסיל
Gorani	גוראני
Matsukaze	מאטסקאזי
Zapatero	זאפאטירו
Sadi	סעדי
Chauvin	שובן
Cruz	קרוז
Hadi	האדי
Revaz	ריבאז
Nobuyuki	נובויוקי
Kozma	קוזמא
Dvorak	דבורז'אק
Benyamin	בנימין
Ouanes	ואניס
Matsuzawa	מאטסוזאוא
Sukha	סוכא
Fadi	פאדי
Joey	ג'וי
Arta	ארטא
Hampton	האמפטון
Norio	נוריו
Menem	מנעם
Grimaldi	גרימאלדי
Rifaat	ריפעט
Qumran	קומראן
Elvis	אלביס
Ashrawi	עשראוי
Breslin	ברסלין
Robredo	רוברידו
Breton	בריטון
Photoshop	פוטושופ
Dacia	דאסיא
Sekularac	סיקולאראק
Illinois	אילינוי
Berlioz	בירליוז
Hokusai	הוקוסאי
Kurtz	קורטז
Mauresmo	מוריסמו
Borgo	בורגו
Yevgeny	יבגני
Bashi	באשי
Istvan	איסטבאן
Shehu	שהו
Gazzaniga	גאזאניגא
Casiraghi	קאסיראגי
Claus	קלאוס
Sofia	סופיא
Miljanic	מילאניטש
Rossi	רוסי
Toshihiko	טושיהיקו
Ricin	ריסין
Downing	דאונינג
Bannatyne	באנאטין
Love	לוב
Correa	קוריא
Dorin	דורין
Vostok	וסטוק
Suzanne	סוזאן
Atlantis	אטלאנטיס
Eichmann	איקמאן
Sergei	סירגיי
Sandor	סאנדור
Kempff	קימפף
Munster	מונסטר
Doris	דוריס
Tiraspol	טיראספול
Lebert	ליברט
Guatemala	גואטימאלא
Atef	עאטף
Buckmaster	באקמאסטר
Berossus	בירוסוס
Lansana	לאנסאנא
Kobe	קובי
Khaldun	חלדון
Stephanopoulos	סטיפאנופולוס
Juande	חואנדי
Coria	קוריא
Sanu	סנוע
Flamion	פלאמיון
Corin	קורין
Domenico	דומיניקו
Kanu	קאנו
Manu	מאנו
Jacinto	ג'אסינטו
Iran	איראן
Kisaichi	קיסאיצ'י
Thucydides	תוקידידיז
Goethals	גותאלס
Chynna	שינא
Peya	פיא
Mosab	מוסעב
Dimoschaki	דימושאקי
Azizi	עזיזי
Mobley	מובלי
Safran	ספרן
Pulcheria	פולכריא
Nagaland	נאגאלאנד
Blazek	בלאזיק
Boris	בוריס
Portland	פורטלאנד
Nighy	נאי
Murayama	מוראיאמא
Barcelata	בארסילאטא
Nikolai	ניקולאי
Titano	טיטאנו
Tunney	טוני
Kabila	קאבילא
Eritrea	אריטריא
Louis	לויס
Stanley	סטאנלי
Lazarus	לאזארוס
Petrus	פטרוס
Santamarina	סאנטאמארינא
Arana	אראנא
Tufts	טאפטס
Sherlock	שרלוק
Bollettieri	בוליטיירי
Tauno	טאונו
Petras	פטראס
Gaspoz	גאספוז
Marlene	מארלין
Takatoki	טאקאטוקי
Alela	אלילא
Schefer	שפר
Herut	חירות
Yo‘ldosh	יולדוש
Fidel	פידל
Petros	פטרוס
Thonglao	תונגלאו
Zamfir	זאמפיר
Kouis	קויס
Lavi	לביא
Bossis	בוסיס
Saretta	סאריטא
Tohir	טוהיר
Peoria	פיוריא
Morandi	מוראנדי
Croatia	קרויישה
Popluhar	פופלוהאר
Poland	פולנד
Mirjalol	מירג'לול
Saleem	סלים
Reagan	רייגן
Childeric	צ'ילדיריק
Uhrlau	אוהרלאו
Rebecca	רביקא
Frankie	פראנקי
Moisiu	מויסיו
Shuichi	שויטשי
Athos	אתוס
Badou	באדו
Grand	גראנד
Zebec	זיביטש
Nikolay	ניקולאי
Trotsky	טרוטסקי
Suksomkit	סוקסומקיט
Rats	ראטס
Kenshin	קינשין
Nigel	נאיג'ל
Tchato	טשאטו
Grant	גראנט
Mats	מאטס
Frank	פראנק
Bats	באטס
Olympic	אולימפיק
Finidi	פינידי
Sissoko	סיסוקו
Mahamadou	מחמדו
Franz	פראנז
Korekiyo	קוריקיו
Hammerfest	האמרפיסט
Marcelo	מארטצ'לו
Abdallah	עבדאללה
Couriol	קוריול
Frans	פראנס
Zenga	זנגא
Boeing	בואינג
Marcos	מארקוס
Masahiro	מאסאהירו
Hagi	האגי
Rodrigo	רודריגו
Wesley	ויסלי
Bearzot	בירזוט
Nagi	נאגי
Konosuke	קונוסוקה
Zajec	זאייטש
Jodar	ג'ודאר
Benoit	בינוא
Chehab	שהאב
Margherita	מארגריטא
Ghiggia	גיגיא
Vlcek	ולצ'ק
Douglas	דוגלאס
Redknapp	רידנאפ
Kewell	קיוול
Portman	פורטמאן
Ozer	עוזייר
Eisner	אייזנר
Zack	זאק
Gundam	גאנדאם
Aractingi	ערקטינגי
Cornelia	קורניליא
Kiefer	קיפר
Ivri	איברי
Jack	ג'ק
Mack	מאק
Stradivarius	סטראדיבאריוס
Macbride	מאקבראיד
Paterson	פאטרסון
Hubbert	הוברט
Voller	בולר
Hashi	האשי
Pnina	פנינה
Marques	מארקיס
Tassotti	טאסוטי
Marcus	מארקוס
Halloumi	חלומי
Mizoram	מיזוראם
Ade	עאד
Carrel	קאריל
Liverani	ליוויראני
Grimsson	גרימסון
Macapa	מאקאפא
Hod	הוד
Lou	לו
Macala	מאצ'אלא
Douis	דויס
Bazooka	באזוקא
Kudrow	קודרו
Shaqaqi	שקאקי
Gottlieb	גוטליב
Whittle	ויטל
Richardson	ריצ'ארדסון
Noreena	נורינא
Weian	ויאן
Nelsen	נלסן
Marbrook	מרברוק
Jassim	ג'אסים
Crispus	קריספוס
Jassem	ג'אסם
Lunney	לאני
Nelson	נלסון
Claesen	קלייסן
Boru	בורו
Mena	מנא
Ryder	ראידר
Bertin	ברטין
Kitano	קיטאנו
Nieminen	ניימינין
Haydn	האידן
Morihiro	מוריהירו
Nandor	נאנדור
Snyder	סנאידר
Sefrioui	ספריוי
Leopardi	ליופארדי
Mitsuo	מיטסו
Anatol	אנאטול
Jableh	גבלה
Portoghesi	פורטוגסי
Koolhaas	קולהאס
Persie	פירסי
Chapman	צ'אפמאן
Helmholtz	הלמהולץ
Tomou	טומו
Nou	נו
Boloni	בולוני
Nishikawa	נישיקאוא
Rabindranath	ראבנדראנאת
Bergmann	ברגמאן
Shagari	שאגארי
Kabul	קאבול
Delson	דילסון
Weisz	ואיז
Codjia	קודג'א
Schiff	שיף
Cassavetes	קאסאביטז
Verkerk	וירקירק
Nathalie	נאטאלי
Weiss	ואיס
Waseige	ואסיג'
Matsushita	מאטסושיטא
Stekelenburg	סטיקלנבירג
Nassim	נאסים
Gerhart	גרהארט
Zyklon	זיקלון
Botero	בוטירו
Compaore	קומפאורי
Tynan	טינאן
Puyol	פויול
Bernanke	בירנאנקי
Boulares	בולעראס
Peter	פיטר
Rasmus	ראסמוס
Mweene	מויני
Kibaki	קיבאקי
Safafa	ספאפא
Kurdahi	קורדאחי
Oranim	אורנים
Voordeckers	וורדיקרז
Paloschi	פאלוסקי
Ustase	יוסטאס
Wojcik	וויצק
Siguroardottir	סיגורורדוטיר
Heather	התר
Zahorski	זאהורסקי
Delgado	דלגאדו
Paz	פאז
Palais	פאלה
Raz	ראז
Ramy	ראמי
Samy	סאמי
Baikonur	באיקונור
Darcis	דארסיס
Hitzlsperger	היטסלפירגר
Chloramphenicol	קלוראמפיניקול
Ishihara	אישיהארא
Lamy	לאמי
Mohaisen	מוחייסן
Bandar	באנדאר
Jakob	ג'אקוב
Aziz	עזיז
Lemmouchia	לימוטשיא
Dinklage	דינקליג'
Yasuhito	יאסוהיטו
Kaori	קאורי
Anka	אנקא
Shamir	שמיר
Braizat	בראיזאט
Lazare	לאזאר
Alnabhani	אלנבהאני
Tatyana	טאטיאנא
Lincoln	לינקולן
Guyana	גויאנא
Zewail	זוייל
Brno	ברנו
Kyuma	קיומא
Mammeri	מעמרי
Korkmaz	קורקמאז
Amel	עאמל
Peron	פירון
Ruy	רוי
Katherine	קאתרין
Tarja	טאריא
Amitav	אמיטב
Szulik	סזוליק
Waldemar	ואלדמאר
Bassem	באסם
Krzynowek	קרזינוויק
Inonu	אינונו
Bassam	בסאם
Multatuli	מולטאטולי
Norihiro	נוריהירו
Buy	באי
Aramid	אראמיד
Bassim	באסים
Guy	גאי
Brosnan	ברוסנאן
Moltke	מולטקה
Jahangir	ג'האנגיר
Paola	פאולא
Gelson	גילסון
Imsaad	אמסאעד
Pedersen	פידרסן
Yacoub	יעקוב
Jarreau	ג'ארו
Wilczek	וילקזק
Paoli	פאולי
Nahariya	נהריה
Paolo	פאולו
Klinghoffer	קלינגופר
Spinoza	ספינוזא
Mackinnon	מאקינון
Majdi	מג'די
Ousmane	עוסמאן
Finkelstein	פינקלסטאין
Grover	גרובר
Ghorban	גורבאן
Marom	מרום
Ballistic	באליסטיק
Maskawa	מאסקאוא
Benito	ביניטו
Soraia	סוראיא
Barlach	בארלאך
Pepin	פפין
Mickael	מקאיל
Grillparzer	גרילפארצר
Zealand	זילאנד
Stupar	סטופאר
Mamadou	מאמאדו
Benelux	בנילוקס
Elm	אילם
Helal	הלאל
Geoff	ג'ף
Jocelyne	ג'וסלין
Palmiro	פאלמירו
England	אנגלאנד
Alec	אליק
Agam	עגם
Tite	טאיט
Larrionda	לאריונדא
Lebed	ליביד
Constantine	קונסטאנטין
Mite	מאיט
Daniela	דאניאלא
Lushan	לושאן
Glazer	גליזר
Yazd	יאזד
Semyonov	סימיונוב
Gronemeyer	גרונמייר
Freddie	פרידי
Radu	ראדו
Kanchelskis	קאנצ'לסקיס
Katharine	קאתארין
Kalanga	קאלאנגא
Price	פראיס
Fatima	פאטימה
Sherman	שרמאן
Reilly	ראילי
Brisbane	בריסביין
Badu	בדו
Chadid	שדיד
Erekat	עריקאט
Bibiana	ביביאנא
Carrie	קירי
Bradesco	בראדיסקו
Foley	פולי
Sljivo	סליבו
Daouda	דואדא
Pieter	פיטר
Keigo	קייגו
Koeman	קומאן
Borneo	בורניו
Merkel	מירקל
Elazar	אלעזר
Basho	באשו
Chaikamdee	צ'איקאמדי
Kengo	קינגו
Miro	מירו
Alanwar	אלאנואר
Stoichita	סטויקיטא
Shelby	שילבי
Ciro	צ'ירו
Shelly	שלי
Chappuzeau	שאפוזיו
Mammedaly	מאמידאלי
Sarpei	סארפיי
Ariadne	אריאדני
Nudelman	נודלמאן
Marbury	מארבורי
Abdoh	עבדו
Gabbidon	גאבידון
Gargula	גארגולא
Welsh	וילש
Slovak	סלובאק
Thutmose	טחוטמוס
Marwan	מרואן
Mokhtar	מוחטאר
Jeremie	ג'רמי
Tylenol	טאילינול
Vujadin	בויאדין
Zuberbuhler	זוברבוהלר
Battir	בטיר
Simoes	סימוז
Konishi	קונישי
Amit	אמית
Rumiko	רומיקו
Musaed	מוסאעד
Oblast	אובלאסט
Simons	סימונז
Hamann	האמאן
Bayda	ביידא
Jacmot	ג'אקמוט
Murano	מוראנו
Concorde	קונקורד
Hamdy	חמדי
Max	מאקס
Goldman	גולדמאן
Shilpa	שילפא
Trice	טראיס
Gunnarsson	גונארסון
Jordao	חורדאו
Shroot	שרוט
Hamdi	חמדי
Goldberg	גולדברג
Sebastiano	סיבאסטיאנו
Shilla	שילא
Schweitzer	שוייצר
Boland	בולאנד
Shilka	שילקא
Dulbecco	דולביקו
Houllier	הולייה
Wiltord	וילטורד
Roberto	רוברטו
Zevulun	זבולון
Bellion	בליון
Wirajuda	ויראיודא
Belletti	ביליטי
Anna	אנא
Bouhired	בוחירד
Maryan	מאריאן
Zermatt	זרמאט
Yunnan	יונאן
Evrytania	אבריטאניא
Horus	חורוס
Chivadze	צ'יבאדזה
Veron	וירון
Bryan	בראין
Haifa	חיפה
Giresse	גיריסי
Stephan	סטיפאן
Paletta	פאליטא
Lamartine	לאמארטין
Pareto	פאריטו
Barbarossa	בארבארוסא
Cruyff	קרויף
Hanssen	האנסן
Maarten	מארטן
Roth	רות
Meron	מירון
Nokia	נוקיא
Nursultan	נורסולטאן
Ziv	זיו
Kisho	קישו
Oliver	אוליבר
Kishi	קישי
Hanyu	האניו
Scholes	סקולז
Yan	יאן
Goth	גות
Nussbaum	נוסבאום
Leroy	לירוי
Mumtaz	מומטאז
Fumihiko	פומיהיקו
Navas	נאבאס
Covey	קובי
Doherty	דוירטי
Hirakawa	היראקאוא
Pamplona	פאמפלונא
Han	האן
Ridley	רידלי
Chalkias	צ'אלקיאס
Cobain	קוביין
Robinson	רובנסון
Nan	נאן
Hanns	האנס
Sofyan	סופיאן
Tzrifin	צריפין
Dan	דן
Fan	פאן
Gan	גאן
Rodzik	רודזיק
Tiempo	טיימפו
Soler	סולר
Gronkjar	גרונקיאר
Alexandra	אלקסנדרא
Pollyanna	פוליאנא
Hanna	חנא
Gammoudi	גמודי
Levchenko	ליבצ'נקו
Weddell	ודל
Alfida	אלפידא
Chen	צ'ן
Hartmut	הארטמוט
Mengele	מנגלה
Sadeghi	סאדגי
Rugova	רוגובא
Jaycee	ג'ייסי
Jefferson	ג'פירסון
Yeager	ייאגר
Krogh	קרוג
Mevo	מיבו
Batman	באטמאן
Veissiere	ויסייר
Stancioiu	סטאנקיו
Tenzing	טינסינג
Tambal	טמבל
Into	אינטו
Stanislav	סטאניסלאב
Stanislaw	סטאניסלו
Foeke	פוקי
Stanislas	סטאנסילאס
Aliyev	עלייב
Piola	פיולא
Micky	מיקי
Copeland	קופלאנד
Kaifu	קאיפו
Annabi	ענאבי
Denis	דניס
Decane	דיקאן
Starr	סטאר
Cristobal	קריסטובאל
Mutran	מוטראן
Deniz	דניז
Mallya	מאליא
Escorial	אסקוריאל
Vera	וירא
Bosnich	בוסניטש
Porterfield	פורטרפילד
Cuevas	קויבאס
Mommens	מומנז
Nomvethe	נומביטי
Summers	סאמרז
Cyrillic	סיריליק
Zeitlin	זאיטלין
Tristan	טריסטאן
Caselli	קאסילי
Tuvalu	טובאלו
Leonov	ליונוב
Shiller	שילר
Suriname	סורינאם
Alaskan	אלסקאן
Demyanenko	דימיאנינקו
Benin	בנין
Halberstam	האלברסטאם
Licka	ליקא
Dimitris	דימיטריס
Reinders	ריינדירס
Burundi	בורונדי
Volandri	בולאנדרי
Gordimer	גורדימר
Thymine	תאימין
Taisir	טאיסיר
Megabyte	מיגאבאיט
Pocahontas	פוקאהונטאס
Marinetti	מאריניטי
Yang	יאנג
Zang	זאנג
Lowenthal	לוינתאל
Kwame	קואמי
Andronicus	אנדרוניקוס
Celso	סילסו
Amioun	אמיון
Blankenstein	בלאנקינסטאין
Bseiso	בסייסו
Borana	בוראנא
Tumelo	טומילו
Calais	קאלה
Debbah	דיבא
Matyas	מאטיאס
Fakroun	פקרון
Sarioglu	סאריוגלו
Lumbini	לומביני
Radovan	ראדובאן
Jorquera	חורקיירא
Bendtner	בנדטנר
Crudup	קרודאפ
Bisha	בישה
Primorsko	פרימורסקו
Sienna	סיאנא
Mahalia	מאהאליא
Vryzas	וריזאס
Miranda	מיראנדא
Elsonbaty	אלסנבאטי
Petr	פיטר
Konchesky	קונשיסקי
Lestrade	ליסטראד
Kandinsky	קאנדינסקי
Hatoyama	האטויאמא
Forest	פוריסט
Harlow	הארלו
Mechner	מקנר
Lombroso	לומברוסו
Viorel	ויוריל
Ganges	גאנג'ז
Baligh	באליג
Skelton	סקלטון
Jocelyn	גוסלין
Okello	אוקילו
Hanny	הני
Cuba	קיובא
Schumacher	שומאכר
Fenin	פינין
Mwai	מואי
Hosseini	חוסייני
Hanoun	חאנון
Kiatisuk	קאיטיסוק
Plessis	פליסיס
Hanni	האני
Eelam	אילאם
Moussa	מוסא
Motoyama	מוטויאמא
Diba	דיבא
Bucaille	בוקאי
Sedik	סדיק
Bonnet	בוניט
Sidi	סידי
Orson	אורסון
Jacobs	ג'ייקובס
Morihei	מוריהיי
Anabta	ענאבטא
Mullis	מוליס
Matviyenko	מאטביינקו
Mahabharata	מהאבהאראטא
Mayakovsky	מאיאקובסקי
Dennis	דניס
Didi	דידי
Sahnoun	סחנון
Zreiq	זריק
Manhattan	מאנהאטן
Mendeleev	מנדלייב
Dirk	דירק
Mozart	מוצארט
Chiklis	צ'יקליס
Travis	טראביס
Estrada	אסטראדא
Chorda	צ'ורדא
Ebeid	עבייד
Gassama	גאסאמא
Greaves	גריבז
Six	סיקס
Toshack	טושאק
Kokoszka	קוקוזקא
Christophe	קריסטוף
Fleming	פלימינג
Curci	קורסי
Huston	היוסטן
Raikkonen	ראיקונן
Damanakis	דאמאנאקיס
Ayrton	אירטון
Mazuz	מאזוז
Boruc	בורוטש
Nour	נור
Bennis	בניס
Richert	ריצ'רט
Danna	דאנא
Vienna	ויינא
Dieter	דיטר
Salomon	סאלומון
Pankhurst	פאנקהורסט
Daedalus	דידאלוס
Crick	קריק
Neeson	ניסון
Pulsa	פולסא
Canna	קאנא
Kaiserslautern	קאיזרסלאוטרן
Film	פילם
Kardec	קארדק
Netanyahu	נوניהו
Viola	ויולא
Progeria	פרוגיריא
Lessing	ליסינג
Trossero	טרוסירו
Bayrou	באירו
Karl	קארל
Myrdal	מירדאל
Dinu	דינו
Masakazu	מאסאקאזו
Nightingale	נאיטינגייל
Carl	קארל
Wuttke	ווטקה
Banderas	באנדיראס
Hughes	היוז
Ryo	ריו
Kanno	קאנו
Konstantinos	קונסטאנטינוס
Masharawi	משהראוי
Memphis	ממפיס
Reimann	ראימאן
Modric	מודריטש
Aeroflot	אירופלוט
Douala	דואלא
Olympiad	אולימפיאד
Hargreaves	הארגריבז
Hubei	הוביי
Anastasius	אנאסטאסיוס
Saviola	סאביולא
Barbara	בארברא
Shabani	שאבאני
Knowles	נוולז
Pond	פונד
Batlles	באטלס
Mamiko	מאמיקו
Battiston	באטיסטון
Muslim	מוסלים
Nitra	ניטרא
Mond	מונד
Buruk	בורוק
Rex	רקס
Cyril	סיריל
Tex	טיקס
Sisto	סיסטו
Darine	דארין
Esti	אסטי
Erbati	ארבאטי
Ghraib	גרייב
Collina	קולינא
Hephaestus	היפיסטוס
Philips	פיליפס
Lacour	לאקור
Sunil	סוניל
Daud	דאוד
Mctiernan	מקטירנאן
Mordechai	מורדכי
Hierro	היירו
Thatta	תאטא
Soderbergh	סודרבירג
Wilders	וילדרז
Tchangai	טצ'אנגאי
Levine	לוין
Herzog	הרצוג
Risto	ריסטו
Luka	לוקא
Givi	גיבי
Boudica	בודיקא
Jarrod	ג'ארוד
Nordahl	נורדאל
Arslan	ארסלאן
Tasmania	טאזמייניא
Treg	טריג
Hillel	הילל
Shimon	שמעון
Callas	קאלאס
Frick	פריק
Mccarthy	מקארתי
Nolberto	נולבירטו
Josep	ג'וסיפ
Thiago	תיאגו
Justin	ג'אסטן
Semmeling	סמילינג
Nakshawani	נאקשוואני
Greg	גריג
Mnari	מנארי
Comaneci	קומאנצ'י
Yuriy	יורי
Gyan	גיאן
Sutee	סוטי
Barmada	ברמדא
Nussimbaum	נוסימבאום
Toriyama	טוריאמא
Anselmo	אנסילמו
Schon	סטשון
Tavares	טאבאריס
Massimo	מאסימו
Rat	ראט
Amsterdam	אמסטרדאם
Lublin	לובלין
Lehmann	ליהמאן
Zenden	זינדן
Tounsi	טונסי
Desmond	דיסמונד
Carducci	קארדוצ'י
Ponedelnik	פונידילניק
Stevens	סטיבנס
Nohair	נוהייר
Klinsmann	קלינסמאן
Gouffran	גופראן
Kemerovo	קימירובו
Kitajima	קיטאג'ימא
Schmidhuber	שמاדהובר
Nikolaou	ניקולאו
Morozov	מורוזוב
Tamra	טאמרא
Arca	ארקא
Kwadwo	קואדוו
Larsen	לארסן
Quaid	קוייד
Kirsten	קירסטן
Jujiro	ג'וג'ירו
Riegel	ריגל
Yamasaki	יאמאסאקי
Danni	דאני
Gigi	ג'יג'י
Nene	ניני
Pad	פאד
Diaby	דיאבי
Obeid	עובייד
Mosteghanemi	מוסטגאנמי
Defoe	דיפו
Jad	ג'אד
Frei	פריי
Danny	דאני
Bartoli	בארטולי
Dunn	דאן
Hyypia	היפיא
Teimuraz	טאימוראז
Krajicek	קראיטשק
Bad	בד
Mounir	מוניר
Dewey	דואי
Gad	גד
Ardiles	ארדיליס
Mulan	מולאן
Senturk	סנטורק
Hick	היק
Firmani	פירמאני
Nick	ניק
Nolasco	נולאסקו
Ghionea	גיוניא
Mommu	מומו
Turgut	טורגוט
Rohr	רוהר
Sfumato	ספומאטו
Munir	מוניר
Merida	מירידא
Estonia	אסטוניא
Elytis	אליטיס
Junnin	ג'ונין
Birnbaum	בירנבאום
Lohr	לוהר
Bertos	בירטוס
Bachir	בשיר
Gorniak	גורניאק
Jibril	ג'יבריל
Lordi	לורדי
Melo	מילו
Nelo	נילו
Valdeir	ואלדייר
Dustin	דאסטין
Belo	בלו
Luc	לוק
Kertesz	קירטיז
Philipp	פיליפ
Pessoa	פיסוא
Kakuei	קאקויי
Vilnai	וילנאי
Guglielmo	גוגלילמו
Rott	רוט
Jaroslav	יארוסלאב
Bonera	בונירא
Kampusch	קאמפוש
Bernstein	ברנסטאין
Paul	פול
Nahyan	נאהיאן
Sneh	סנה
Saul	סול
Souayah	סויאח
Chalana	צ'אלאנא
Gable	גייבל
Kaufman	קאופמאן
Bidouane	בדואן
Arbid	ערביד
Charalambos	צ'אראלאמבוס
Scalia	סקאליא
Menchu	מנצ'ו
Amuneke	אמוניק
Patti	פאטי
Arbil	ארביל
Ferrara	פירארא
Sawt	סאוט
Lyonnais	ליונה
Jordi	יורדי
Brammertz	בראמירץ
Ontario	אונטייריו
Niko	ניקו
Qosimov	קוסימוב
Kakonje	קאקונג'י
Russo	רוסו
Zurawski	זוראוסקי
Krakatoa	קראקאטוא
Buckley	באקלי
Erhard	ארהארד
Piano	פיאנו
Shwery	שוירי
Khalaf	חלף
Purcell	פורסל
Cynthia	סינתיא
Barbra	בארברא
Burd	בורד
Piccinino	פיטשינינו
Dublin	דבלין
Austin	אוסטין
Nery	נירי
Gillespie	גיליספי
Bahja	בהג'א
Yunus	יונוס
Diarra	דיארא
Matejovsky	מאטיובסקי
Naotake	נאוטאקי
Hiranuma	היראנומא
Empoli	אמפולי
Yagur	יאגור
Gryzlov	גריזלוב
Fanny	פאני
Steffi	שטיפי
Megalith	מיגלית
Tanaka	טאנאקא
Legia	ליגיא
Rosenior	רוסיניור
Presley	פריסלי
Mstislav	מסטיסלאב
Knepper	נפר
Greenpeace	גרינפיס
Lascelles	לאסילס
Severino	סיבירינו
Herschel	הירשיל
Evgeny	איבגיני
Suskind	סוסקינד
Romarin	רומארין
Sarriegi	סאריגי
Zweig	צבאיג
Ammonium	אמוניום
Yoav	יואב
Buber	בובר
Liz	ליז
Boonen	בונן
Mcavoy	מקאבוי
Lovett	לוביט
C.	ק.
Narimene	נארימן
London	לונדן
Benetti	בניטי
Gutzkow	גוטסקוב
Toshihide	טושיהידה
Brunel	ברוניל
Hulagu	הולאגו
Magister	מאג'יסטר
Tonegawa	טוניגאוא
Ortega	אורטיגא
Swindin	סוינדן
Chinghiz	צ'נגיז
Yamazaki	יאמאזאקי
Aguero	אגוירו
Shkoder	שקודר
Patrick	פאטריק
Villette	ויליט
Elisabeth	אליזאבת
Christiaan	קריסטיאן
Qubad	קובאד
Brigham	בריגם
Nottingham	נוטינגהאם
Billel	בילל
Musso	מוסו
Kepler	קפלר
Tracy	טרייסי
Hosny	חוסני
Jupp	יופ
Dane	דיין
Saakashvili	סאקאשבילי
Quan	קואן
Barbosa	בארבוסא
Suan	סואן
Hosni	חוסני
Graves	גרייבז
Joop	ג'ופ
Juan	חואן
Kuan	קואן
Torres	טוריס
Samba	סאמבא
Delaware	דלאוור
Pasco	פאסקו
Polykleitos	פוליקליטוס
Borlaug	בורלוג
Ramat	ראמאט
Potato	פוטאטו
Gropius	גרופיוס
Yakutsk	יאקוטסק
Mintz	מינץ
Susumu	סוסומו
Orinoco	אורינוקו
Uri	יורי
Bilirubin	בילירובין
Hiele	הילי
Cedrick	סידריק
Aconcagua	אקונקאגוא
Monaco	מונאקו
Eri	אירי
Zahovic	זאהוביטש
Beynie	בייני
Hamrouche	חמרוש
Drake	דרייק
Hiroshige	הירושיגה
Parthenon	פארתינון
Ustinov	יוסטינוב
Croce	קרוצ'י
Westermann	ויסטרמאן
Dorinel	דורינל
Federico	פידיריקו
Kaczynski	קאטשינסקי
Croci	קרוקי
Sychev	סיטשב
Berger	ברגר
Reuter	רויטר
Modena	מודנה
Ryotaro	ריוטארו
Bohlin	בוהלין
Dieudonne	דיודון
Armando	ארמאנדו
Aslan	אסלאן
Shawn	שון
Avogadro	אבוגאדרו
Tintoretto	טינטוריטו
Espirito	אספיריטו
Shidehara	שידיהארא
Bhatia	באטיא
Hesselink	היסילינק
Brock	ברוק
Cortes	קורטיס
Valente	ואלנטי
Bardem	בארדם
Zorro	זורו
Castro	קאסטרו
Frege	פריגה
Kahalani	קהלאני
Drazan	דראזן
Remi	רימי
Bentley	בנטלי
Patricia	פאטרישא
Zakariya	זקריא
Albert	אלברט
Viani	ויאני
Schulze	שולצה
Huayna	הואינא
Voynov	בוינוב
Bakkati	בקאטי
Claudius	קלאודיוס
Viana	ויאנא
Riedle	רידל
Grande	גראנד
Begin	בגין
Rochelle	רושיל
Spallanzani	ספאלאנזאני
Shady	שאדי
Todd	טוד
Selemani	סלימאני
Tinian	טיניאן
Tiersen	טירסן
Lacuesta	לאקויסטא
Schubert	שוברט
Sonnenschein	זוננשאין
Nwaneri	נואנירי
Shusaku	שוסאקו
Schiller	שילר
Turandot	טוראנדוט
Valdivia	ואלדיביא
Ribery	ריברי
Karagounis	קאראגוניס
Aqaba	עקבה
Kutcher	קאטשר
Giorgio	ג'ורג'ו
Naseer	נסיר
Ngatjizeko	נגאטג'זיקו
Guirane	גויראני
Abdou	עבדו
Rizzitelli	ריציטילי
Visitor	ויסיטור
Gibli	גיבלי
Sarinana	סארינאנא
Zhou	ז'ו
Liane	ליאן
Yasser	יאסר
Youri	יורי
Ivanovo	איבאנובו
Wojciech	וויסיטש
Maxim	מקסים
Beinisch	ביניש
Jawdat	ג'אודאט
Preseren	פריסירן
Preity	פריטי
Morris	מוריס
Roberts	רוברטס
Hawaii	האואי
Isilkul	איסילקול
Hoeneß	הוניס
Elsamni	אלסמני
Mercure	מירקיור
Diawara	דיאוארא
Petrosian	פיטרוסיאן
Hadchiti	חדשיטי
Ndlovu	נדלובו
Aljaldaki	אלג'לדאקי
Andre	אנדריי
Yeboah	ייבוא
Johannesburg	ג'והאנסברג
Bercellino	ברצ'לינו
Rivera	ריבירא
Soyinka	סוינקא
Majorelle	מאג'וריל
Hilbert	הילברט
Mehran	מהראן
Burqa	בורקע
Jiang	ג'יאנג
Borchardt	בורשארדט
Sarabia	סאראביא
Molby	מולבי
Sturridge	סטוריג'
Stoor	סטור
Pam	פאם
Hieronymus	הירונימוס
Tigana	טיגאנא
Holden	הולדין
Koechner	קושניר
Parsons	פארסונס
Syed	סייד
Omaar	עומר
Zach	זאק
Tushino	טושינו
Aleksei	אלקסיי
Leko	ליקו
Giraldo	גיראלדו
Jerko	ג'רקו
Dupre	דופרי
Cambodia	קמבודיא
Xin	זין
Vasco	ואסקו
Torre	טורי
Johansson	יוהאנסון
Nhlapo	נהאלפו
Qin	קוין
Arnaud	ארנו
Drulovic	דרולוביטש
Simukonda	סימוקונדא
Win	וין
Christopher	קריסטופר
Laszlo	לאסזלו
Lin	לין
Strack	סטראק
Ryuji	ריוג'י
Bin	בין
Shield	שילד
Veronicas	ורוניקאז
Humberto	הומבירטו
Braila	בראילא
Kerkouane	קרקואן
Spen	ספין
Volta	וולטא
Leslie	ליסלי
Kiarostami	קיארוסטאמי
Abigail	אביגייל
Mourid	מוריד
Hatshepsut	חטשפסוט
Apichet	אפיצ'ט
Mourad	מוראד
Kazuki	קאזוקי
Berthod	בירתוד
Novotel	נובוטל
Zaid	זאיד
Polat	פולאט
Elliott	אליוט
Paulina	פאולינא
Said	סעיד
Santangelo	סאנטאנג'לו
Mirsad	מירסאד
Ghosh	גוש
Bettino	בטינו
Kubar	קובאר
Shefer	שפר
Diane	דיאן
Yerevan	יריבאן
Spanic	ספאניק
Romero	רומירו
Diana	דיאנא
Toyoda	טויודא
Poussin	פוסן
Nicolaus	ניקולוס
Bukhara	בוכארא
Caldera	קאלדירא
Lee	לי
Hayam	היאם
Newton	ניוטן
Moby	מובי
Taft	טאפט
Albanna	אלבנא
Lossemy	לוסימי
Treviso	טריביסו
Hussam	חוסאם
Kotaro	קוטארו
Papon	פאפון
Shikibu	שיקיבו
Ciano	צ'אנו
Kirilenko	קירילנקו
Shojaei	שוג'אעי
Judit	ג'ודית
Takahiro	טאקאהירו
Mustafa	מוסטפא
Dink	דינק
Tanganyika	טנגאניקא
Camilla	קאמילא
Gounaris	גונאריס
Solomon	סולומון
Gilberto	גילברטו
Anthony	אנתוני
Chedli	שאדלי
Nepal	נפאל
Virginie	וירג'יני
Motorola	מוטורולא
Plunkett	פלאנקיט
Cossery	קוסרי
Radice	ראדישי
Homocysteine	הומוסיסטין
Kyrgiakos	קירגיאקוס
Marilyn	מארילין
Vasili	عאסילי
Khums	חומס
Kremers	קרימרז
Audo	אודו
Hecuba	היקובא
Asik	אסיק
Jacquard	ג'אקאר
Radojko	ראדויקו
Sherihan	שריהאן
Kuffer	קאפר
Enrico	אנריקו
Raschke	ראשקי
Tarek	טארק
Pinochet	פינושה
Hamasaki	האמאסאקי
Bouzarah	בוזארה
Camby	קאמבי
Comics	קומיקס
Abba	אבא
Rosenthal	רוזנטאל
Reichs	ריקס
Mekawy	מקאוי
Pompon	פומפון
Lidocaine	לידוקאין
Frances	פראנסס
Mandola	מאנדולא
Hobbes	הובז
Kaboul	קאבול
Mbabane	מבאבאן
Werner	ורנר
Planinc	פלאנינק
Redmond	רדמונד
Mendelssohn	מנדלסון
Nubar	נובאר
Kurosawa	קורוסאוא
Spanish	ספאניש
Raphael	רפאל
Kurokawa	קורוקאוא
Vassell	ואסיל
Matilde	מאטילדי
Suraski	סוראסקי
Cameroon	קאמירון
Wangchuck	ואנגצ'וק
Field	פילד
Barnea	בארניא
Tilman	טילמאן
Kremnitz	קרמניץ
Sabina	סאבינא
Kluivert	קלויברט
Donetsk	דונטסק
Imperia	אמפיריא
Kayal	קאיאל
Baikal	באיקאל
Tortola	טורטולא
Mahfouz	מחפוז
Goian	גויאן
Kerviel	קרבייל
Hajeri	חג'רי
Trulli	טרולי
Petty	פיטי
Seb	סב
Harbin	הארבין
Berlin	ברלין
Romi	רומי
Luxemburgo	לאקסומבורגו
Dostoyevsky	דוסטויבסקי
Mazowiecki	מאזויקי
Spike	ספאיק
Vivien	ויויאן
Wendy	ונדי
Norrie	נורי
Istanbul	איסטנבול
Macfadyen	מאקפאדין
Atiyah	עטיה
Harel	הראל
Assaf	עסאף
Roderick	רודריק
Naik	נאיק
Ghezal	גזאל
Declan	דקלן
Morton	מורטן
Transylvania	טראנסילוואניא
Dimethyl	דימיתיל
Tresor	טריסור
Koblenz	קובלנז
Toure	טורה
Mitterrand	מיטיראן
Shiraishi	שיראישי
Morten	מורטן
Touro	טורו
Kyi	קי
Gamar	גמר
Ringo	רינגו
Jia	ג'יא
Lia	ליא
Mia	מיא
Azouz	עזוז
Notting	נוטינג
Nikolic	ניקוליטש
Bessemer	בסימר
Lai	לאי
Taryn	טארין
Mendy	מנדי
Maxfield	מאקספילד
Christina	קריסטינא
Knight	נאיט
Christine	קריסטין
Hulk	הלק
Fatmir	פאטמיר
Canning	קאנינג
Tamar	תמר
Lyndon	לינדון
Lashley	לאשלי
Pentecost	פנטיקוסט
Rosalynn	רוזאלין
Audin	אודן
Maureen	מורין
Marek	מאריק
Honecker	הוניקר
Badr	בדר
Nowruz	נורוז
Holiday	הולידאי
Mansouri	מנסורי
Correia	קוריא
Yoritomo	יוריטומו
Laursen	לאורסן
Assia	אסיא
Montague	מונטאגיו
Lynne	לין
Madhya	מאדהיא
Alali	אלעלי
Souleymanou	סוליימאנו
Zeller	זלר
Warsaw	וארסו
Wislander	וסלנדר
Guerrero	גורירו
Muntyan	מונטיאן
Schlossberg	שלוסברג
Colvin	קולווין
Dayan	דיין
Loetscher	לוטשר
Bilady	בילאדי
Baggio	באג'יו
Kapadze	קאפאדזה
Bodart	בודארט
Cameron	קאמירון
Pierre	פיאר
Elshafei	אלשאפעי
Pires	פיריז
Bataysk	באטאיסק
Mariusz	מאריוס
Heaviside	היביסאיד
Ramaz	ראמאז
Riyad	ריאד
Arghun	ארגון
Karel	קאריל
Naelson	ניילסון
Karen	קארן
Polynesia	פוליניזיא
Gabilondo	גאבילונדו
Pierce	פירס
Hammond	האמונד
Monteiro	מונטירו
Riggott	ריגוט
Vukcevic	ווקסיביטש
Petropolis	פטרופוליס
Schweinsteiger	שבאינשטאיגר
Tauziat	טוזיא
Beirut	בירות
Apollinaris	אפולינאריס
Timorim	טימורים
Het	היט
Jet	ג'ט
Marcomanni	מארקומאני
Goll	גול
Akhalkalaki	אכאלקאלאקי
Matadi	מאטאדי
Jared	ג'אריד
Leonidas	ליונידס
Gerets	גיריץ
Sihanouk	סיהאנוק
Silvio	סילביו
Norton	נורטן
Sauer	סאוור
Indonesia	אינדוניז'א
Petric	פטריטש
Exxon	אקסון
Vitaly	ויטאלי
Mildred	מילדריד
Baeza	באיזא
Vantaa	ואנטא
Farshad	פרשאד
Viacom	ויאקום
Fanning	פאנינג
Anton	אנטון
Bertelsen	בירטילסן
Hamad	חאמאד
Volz	וולץ
Tomei	טומיי
Austria	אוסטריא
Brod	ברוד
Youzhny	יוז'ני
Buretsu	בוריטסו
Sayako	סאיאקו
Farouk	פארוק
Pancsics	פאנקסיקס
Rudolph	רודולף
Pope	פופ
Hidaka	הידאקא
Georges	ג'ורג'
Paasilinna	פאסילינא
Bushmen	בושמן
Bebeto	ביביטו
Hope	הופ
Yahya	יחיא
Berner	בירנר
Mitsuki	מיטסקי
Matsui	מאטסוי
Greenspan	גרינספאן
Szavay	סאבאי
Yaya	יאיא
Dixit	דיקסיט
Vasilis	ואסיליס
Tafer	טאפר
Zizka	זיזקא
Debbouze	דבוז
Paris	פאריס
Rakosi	ראקוסי
Elijah	אלאיג'ה
Haya	היה
Hakki	חקי
Narey	נארי
Nahnah	נחנאח
Raslan	רסלאן
Floriano	פלוריאנו
Mertesacker	מירטסאקר
Mykhaylychenko	מיכאליטשינקו
Peggy	פגי
Rei	רי
Hauer	האויר
Ibtisam	איבטיסאם
Hyang	היאנג
Wei	ויי
Safet	סאפיט
Madeleine	מאדלין
Patsatzoglou	פאצאצוגלו
Luxemburg	לוקסמבורג
Stamile	סטאמאיל
Segway	סגוויי
Hayato	האיאטו
Rachael	ראיצ'ל
Costello	קוסטילו
Biros	בירוש
Gray	גריי
Speirs	ספירז
Robinsons	רובינסונז
Galland	גאלאנד
Eyvind	איבינד
Cabrera	קאברירא
Sid	סיד
Vautrot	ואוטרוט
Roleder	רולדר
Pinchas	פנחס
Ginsburg	גינסבורג
Krankl	קראנקל
Yulianto	יוליאנטו
Suzuki	סוזוקי
Paulus	פאולוס
Cid	סיד
Rostom	רוסטום
Denholm	דנהולם
Lutfi	לוטפי
Prescott	פריסקוט
Pruzzo	פרוצו
Devilder	דיבאילדר
Norte	נורט
Massi	מאסי
Mellberg	מלבירג
Carew	קארו
Andrew	אנדרו
Bernie	ברני
Umbria	אומבריא
Youssra	יוסרא
Seiji	סייג'י
Kodjo	קודג'ו
Sotirios	סוטיריוס
Goldstein	גולדסטין
Eindhoven	אנדהובן
Mitchell	מיטשל
Naphtali	נפתלי
Hafez	חאפז
Baldry	באלדרי
Sadok	סאדוק
Nasser	נאסר
Jamal	ג'מאל
Dariusz	דאריוש
Federline	פידרלאין
Mongke	מונקי
Shirin	שירין
Kranjcar	קראניקאר
Nouri	נורי
Marti	מארטי
Migliore	מיגליורי
Vern	וירן
Garadanow	גאראדאנוב
Chambers	שאמבירס
Mileva	מיליבא
Radoi	ראדוי
Blumenthal	בלומנתאל
Shibam	שיבאם
Bouraoui	בוראוי
Best	בסט
Abedi	עבידי
Estadio	אסטאדיו
Sabir	סאביר
Guantanamo	גואנטאנאמו
Sandrelli	סאנדרילי
Ascii	אסקי
Bogart	בוגארט
Sipos	סיפוס
Omar	עומר
Amar	עמאר
Mannheim	מאנהאים
Nehru	נהרו
Sulakvelidze	סולאקבלידזה
Sabin	סאבין
Zenawi	זינאוי
Genda	גנדא
Aumann	אומאן
Teddy	טדי
Hercules	הירקיוליז
Akayev	אקאייב
Vierne	וירן
Knezevic	ניזיביטש
Taher	טאהר
Ziryab	זיריאב
Boka	בוקא
Plautz	פלאוץ
Rabie	רביע
Vucinic	בוסיניטש
Leone	ליון
Rabia	רביע
Fendi	פינדי
Khoury	חורי
Lew	לו
New	ניו
Sodium	סודיום
Kenta	קינטא
Netto	ניטו
Moliere	מולייר
Zaimoglu	זאימוגלו
Mirel	מירל
Mirek	מיריק
Foote	פוט
Hollerith	הולירית
Patil	פאטיל
Novotna	נובוטנא
Yelena	ילינא
Roentgenium	רונטגניום
Kehl	קאהל
Salmeen	סאלמין
Peruggia	פירוגיה
Menderes	מנדיריס
Maskhadov	מסכאדוב
Abeokuta	אביוקוטא
Sizemore	סאיזמור
Dniester	דניסטר
Sahel	סאחל
Galakos	גאלאקוס
Stefka	סטיפקא
Pausini	פאוזיני
Fares	פארס
Venter	וינטר
Pastrana	פאסטראנא
Polanski	פולאנסקי
Zoran	זוראן
Golan	גולן
Antonia	אנטוניא
Meller	מילר
Ballut	בלוט
Sucralose	סוקרלוס
Jomei	ג'ומיי
Brolin	ברולין
Habib	חביב
Gustaf	גוסטאף
Dini	דיני
Mitsumune	מיטסומוני
Kwon	קוון
Bormann	בורמאן
Meiji	מייג'י
Pinel	פיניל
Jose	חוסה
Sakichi	סאקיצ'י
Ferrer	פרר
Nasdaq	נאסדאק
Sondergaard	סונדרגארד
Hawthorne	האותורן
Oldham	אולדהאם
Lovell	לוביל
Hanks	האנקס
Virginia	וירג'יניא
Stepanakert	סטיפאנאקירט
Aki	אקי
Starck	סטארק
Surgut	סורגוט
Clerc	קלירק
Dindane	דנדאני
Jaspers	יאספרז
Keller	קלר
Hanke	האנקי
Gokhan	גוכאן
Bette	ביט
Brooking	ברוקינג
Pospech	פוספיך
Betta	ביטא
Connors	קונרז
Dorothy	דורותי
Croydon	קרוידון
Kanafani	קנפאני
Bobby	בובי
Keiji	קייג'י
Bubernik	בוברניק
Rajavi	רג'אבי
Masudi	מאסודי
Horiuchi	הוריוצ'י
Rosneft	רוסנפט
Salibi	סליבי
Ashkelon	אשקלון
Maris	מאריס
Irbid	אירביד
Marin	מארין
Klan	קלאן
Kerimov	קרימוב
Stambachr	סטאמבאכר
Zennstrom	זינסטרום
Alan	אלן
Feiler	פיילר
Carles	קארלס
Finkielkraut	פינקילקרוט
Big	ביג
Tagoe	טאגו
Ivanhoe	איבאנהו
Carlos	קארלוס
Bregerie	בריגירי
Haminu	האמינו
Chyler	טשילר
Gehry	גירי
Maamar	מועמר
Stylites	סטאילאיטס
Fode	פוד
Baltaah	בלטעה
Traill	טרייל
Mubarak	מובארק
Gobbi	גובי
Bantustan	באנטוסטאן
Milosz	מילוש
Senaki	סינאקי
Julius	ג'וליוס
Neil	ניל
Kollhoff	קולהוף
Melvil	מלביל
Papa	פאפא
Shafiq	שפיק
Debbagh	דבאג
Kabil	קאביל
Sinclair	סינקלייר
Grabar	גראבאר
Puricelli	פוריצ'לי
Maher	מאהר
George	ג'ורג'
Bolkiah	בולקיה
Spector	ספקטור
Brendan	ברנדאן
Hashim	האשים
Bauer	באוור
Capa	קאפא
Sestic	ססטיק
Unit	יוניט
Dhorasoo	דוראסו
Bijeljina	ביילינא
Brennan	ברינאן
Anomer	אנומר
Vanoni	ואנוני
Ofakim	אופקים
Tichy	טיצ'י
Halimi	חלימי
Shunsuke	שונסוקי
Stevenson	סטיבנסון
Jerkovic	ירקוביטש
Thrace	תרייס
Maniche	מאניש
Hugues	הוגיז
Bobo	בובו
Dolph	דולף
Brixton	בריקסטון
Aritomo	אריטומו
Liman	לימאן
Torah	תורה
Niigaki	ניגאקי
Thalassemia	תלאסימיא
Aldrin	אלדרין
Holon	חולון
Balaton	באלאטון
Tadmor	טדמור
Madanchi	מעדנצ'י
Piturca	פיטורקא
Reiki	רייקי
Solaris	סולאריס
Henry	הנרי
Helguera	הילגירא
Aleksander	אלקסנדר
Mona	מונא
Pierluigi	פיירלויג'י
Almaszadeh	אלמאסזאדה
Tsutomu	טסוטומו
Mladic	מלאדיטש
Henri	הנרי
Zana	זאנא
Nikolaev	ניקולאייב
Cornthwaite	קורנתויט
Lavon	לאבון
Sidon	סידון
Anand	אנאנד
Dretar	דריטאר
Latimer	לאטימר
Siddiq	סדיק
Kramnik	קראמניק
Rep	רפ
Nabil	נביל
Ransford	ראנספורד
Menichelli	מניקילי
Timo	טימו
Magdi	מגדי
Vladikavkaz	ולאדיקאבקאז
Mashhad	משהד
Bluetooth	בלוטות'
Kyrastas	קיראסטאס
Mathijsen	מאתיסן
Gibson	גיבסון
Jawad	ג'אואד
Baronio	בארוניו
Klose	קלוס
Yuryaku	יוריאקו
Hopkins	הופקינס
Ludwig	לודביג
Sammy	סאמי
Sibiu	סיביו
Baqir	באקיר
Cortisol	קורטיזול
Guderian	גודיריאן
Vedran	ודראן
Fransman	פראנסמאן
Fred	פריד
Rinaldo	רינאלדו
Ziege	זיגה
Booy	בוי
Bridget	בריג'ט
Grichting	גריקטינג
Ibn	איבן
Batt	באט
Hristo	הריסטו
Kanther	קאנתר
Sokolow	סוקולוב
Osvaldo	אוסבאלדו
Kreisky	קרייסקי
Hrbaty	הרבאטי
Wozniacki	בוזניאקי
Tardelli	טארדילי
Magog	מגוג
Dolores	דולוריס
Leonhard	ליונהארד
Akl	עקל
Katip	קאטיפ
Bohm	בום
Graf	גראף
Oldfield	אולדפילד
Morro	מורו
Olarra	אולארא
Dien	דין
Nimar	נימר
Kavakci	קאוקג'י
Katie	קייטי
Bahjat	בהג'ט
Shapley	שייפלי
Larnaca	לארנקא
Macau	מאקאו
Talebloo	טאלבלו
Salem	סיילם
Saganowski	סאגאנווסקי
Toto	טוטו
Costanza	קוסטאנזא
Morjane	מורג'יין
Yohan	יוהאן
Conrad	קונראד
Noto	נוטו
Adivasi	אדיבאסי
Shalmaneser	שלמנסר
Karpin	קארפן
Yukichi	יוקיצ'י
Delvecchio	דלביקיו
Myanmar	מיאנמאר
Goto	גוטו
Hananu	הנאנו
Moran	מוראן
Mbuyane	מבויאן
Holyfield	הוליפילד
Elgamal	אלגמל
Drewry	דרורי
Mulenga	מולינגא
Nikki	ניקי
Mehri	מהרי
Samaras	סאמאראס
Qvist	קביסט
Ofra	עפרה
Haraam	חראם
Puerta	פוארטא
Zell	זיל
Rhee	רי
Hebert	היבירט
Selena	סילינא
Glotov	גלוטוב
Bassala	באסאלא
Claude	קלוד
Kazuya	קאזויא
Hinkel	הינקל
Fekri	פקרי
Banks	באנקס
Tori	טורי
Harissa	חריסא
Bell	בל
Miyuki	מיוקי
Vujovic	בויוביטש
Rasa	ראסא
Lori	לורי
Mori	מורי
Nori	נורי
Seitaridis	סיטארידיס
Hayatou	חיאטו
Sivok	סיבוק
Cori	קורי
Dori	דורי
Tork	טורק
Kent	קנט
Nasa	נאסא
Shmuel	שמואל
Calum	קאלום
Baher	באהר
Bent	בנט
Davor	דאבור
Kaliningrad	קאלינינגראד
Augustin	אוגסטין
Tserkva	טסירקבא
Demerit	דימיריט
Planck	פלאנק
Shabab	שבאב
Chaidari	חאידארי
Sampaio	סאמפאיו
Hitomi	היטומי
Gross	גרוס
Dimona	דימונה
Heche	הש
Dehn	דהן
Fehn	פיהן
Volodymyr	וולודימיר
Dror	דרור
Meeno	מינו
Aimar	אימאר
Beiteinu	ביתנו
Nikita	ניקיטא
Schultz	שולטז
Alta	אלטא
Steinbeck	סטיינבק
Nozomi	נוזומי
Helena	הלנא
Scorsese	סקורסיזי
Souad	סועאד
Mcbride	מקבראיד
Sneijder	שנאידר
Djebar	ג'באר
Rafal	ראפאל
Uganda	אוגאנדא
Rafah	רפח
Lobodzinski	לובודזינסקי
Ribeiro	ריביירו
Khanaqin	חאנאקין
Wright	ראיט
Tocantins	טוקאנטינז
Muti	מוטי
Grandes	גראנדס
Silvestre	סילביסטר
Hass	האס
Schneiderhan	שנאידרהאן
Modise	מודיסי
Recouderc	ריקודירק
Svetoslav	סביטוסלאב
Bass	באס
Camaro	קאמארו
Boateng	בוטינג
Pious	פאיוס
Kyoto	קיוטו
Minkowski	מינקובסקי
Shai	שי
Thai	טאי
Kossel	קוסל
Naeim	נעים
Keene	קין
Panenka	פאנינקא
Duisburg	דויסבורג
Bamako	באמאקו
Obama	אובאמא
Fahed	פאהד
Pellegrini	פיליגריני
Miguel	מיגל
Serj	סירג'
Vahid	וחיד
Jozef	ג'וזף
Embraer	אמבראיר
Lussenhoff	לוסינהוף
Fortuny	פורטוני
Ashdown	אשדאון
Riyashi	ריאשי
Agassi	אגאסי
Cook	קוק
Lausanne	לוזאן
Yamagishi	יאמאגישי
Sousa	סוזא
Sabur	סאבור
Durs	דורס
Pedro	פדרו
Maneiro	מאניירו
Apso	אפסו
Bikila	ביקילא
Mosley	מוזלי
Iba	איבא
Schafik	שפיק
Zohar	זוהר
Sagunto	סאגונטו
Ghotbzadeh	גוטבזאדה
Bremner	ברימנר
Nasrallah	נסראללה
Todorov	טודורוב
Sidhom	סידהום
Tamoxifen	טאמוקסיפין
Sussmuth	סוסמות
Sholes	שולז
Haidong	האידונג
Vale	וייל
Santon	סאנטון
Galili	גלילי
Amanda	אמאנדא
Metallica	מיטאליקא
Hatsumi	האטסומי
Bundy	בנדי
Arazi	ארזי
Koken	קוקן
Thabo	תאבו
Dale	דייל
Forssmann	פורסמאן
Connery	קונרי
Cronbach	קרונבאך
Yardley	יארדלי
Hirsi	הירסי
Timmy	טימי
Roseau	רוסו
Huerta	הוארטא
Nisr	ניסר
Alberti	אלברטי
Coras	קוראס
Smertin	סמירטין
Redd	רד
Lauridsen	לאורידסן
Stapleton	סטייפלטון
Yasuda	יאסודא
Rehman	רחמאן
Cecilia	סיסיליא
Gramsci	גראמשי
Troels	טרולז
Nimitz	נימיץ
Kadhim	קאדים
Boral	בוראל
Fatih	פאטיח
Topolanek	טופולאניק
Hayao	האיאו
Golanski	גולאנסקי
Mitic	מיטיטש
Delphi	דילפי
Thuram	טוראם
Narazaki	נאראזאקי
Gariseb	גאריסב
Delilah	דלאילה
Yosa	יוסא
Nunavut	נונאבוט
Shinoda	שינודה
Peck	פיק
Heidegger	האידגר
Tony	טוני
Troost	טרוסט
Tanya	טאניא
Sanders	סאנדרז
Kumm	קום
Deena	דינא
Iroquois	אירוקויס
Potocari	פוטוקארי
Dodoma	דודומא
Shola	שולא
Daniels	דאניילז
Ronen	רונן
Clearwater	קלירווטר
Knez	ניז
Ginzburg	גינסבורג
Vava	ואוא
Babangida	באבנגידא
Lava	לאבא
Solow	סולו
Maslachenko	מאסלאצ'נקו
Wada	ואדא
Hedi	הדי
Antigua	אנטיגוא
Lada	לאדא
Micah	מיקה
Umaru	עמארו
Mozambique	מוזאמביק
Tico	טיקו
Vitalis	ויטאליס
Goran	גוראן
Bahi	באהי
Shaker	שאקר
Meeuws	מיוס
Hanoune	חנון
Brahe	בראהי
Parc	פארק
Jules	ז'ול
Alvarado	אלבאראדו
Fico	פיקו
Aliaksandr	אליאקסאנדר
Lorenz	לורנז
Norodom	נורודום
Rehhagel	ריהאגל
Cardilli	קארדילי
Koster	קוסטר
Jeandupeux	ג'אנדופו
Reinhardt	ראינהארט
Stevie	סטיבי
Cleopatra	קליופאטרא
Raymond	ראימונד
Coxon	קוקסון
Markov	מארקוב
Kipling	קיפלינג
Ferdinand	פרדינאנד
Ruwi	רוי
Bliss	בליס
Koda	קודא
Vanaheimr	ואנאהימר
Koudas	קודאס
Verlaine	ורלן
Djian	דג'יאן
Vercauteren	ורקואטירין
Payne	פיין
Reijiro	רייג'ירו
Bezos	ביזוס
Goda	גודא
Chafurin	צ'אפורין
Willem	וילם
Burla	בורלא
Hofi	חופי
Sputnik	ספוטניק
Kofi	קופי
Massaro	מסארו
Kallon	קאלון
Cutty	קאטי
Tomasi	טומאסי
Sloan	סלון
Butte	ביוט
Quintin	קוינטין
Rusk	ראסק
Layton	לייטון
Benicio	ביניסיו
Pranjic	פראניטש
Marcelino	מארסילינו
Strittmatter	סטריטמאטר
Ramljak	ראמליאק
Geena	גינא
Busk	באסק
Saifi	סאיפי
Tendillo	טינדילו
Prati	פראטי
Elias	אליאס
Marouf	מערוף
Milligan	מיליגאן
Santoro	סאנטורו
Gestapo	גסטאפו
Jerusalem	ג'רוסאלם
Livingstone	ליבינגסטון
Spiegel	ספיגל
Mehaidli	מחידלי
Mashego	מאשיגו
Gallagher	גאלאגר
Flanders	פלאנדרז
Neot	ניות
Roggeveen	רוגיבין
Thoreau	תורו
Sugiyama	סוגייאמא
Libeskind	ליבסקינד
Durkheim	דורקהיים
Tyson	טאיסון
Dzajic	דזאג'יטש
Nostra	נוסטרא
Keynes	קינז
Litvinov	ליטבינוב
Helou	חלו
Schroeder	שרודר
Bathory	באטורי
Giolitti	ג'וליטי
Wooddin	וודן
Kusumi	קוסומי
Mochizuki	מוצ'יזוקי
Tiverton	טיבירטון
Konev	קוניב
Zamorano	זאמוראנו
Lenstra	לינסטרא
Blanco	בלאנקו
Fisher	פישר
Romanos	רומאנוס
Coriolis	קוריוליס
Jimmy	ג'ימי
Glutamine	גלוטאמין
Melrose	מלרוז
Pristina	פריסטינא
Rosenblum	רוזנבלום
Diyarbakr	דיארבקר
Radiohead	ראדיוהד
Mahmoud	מחמוד
Billong	בילונג
Dasayev	דאסאייב
Jusufi	יוסופי
Jones	ג'ונז
Kingston	קינגסטון
Yonai	יונאי
Coolidge	קולידג'
Lavigne	לאבין
Sigrid	סיגריד
Adair	אדייר
Zune	זון
Falkenmayer	פאלקינמאיר
Bouab	בועב
Blagoja	בלאגויה
Donner	דונר
Kanye	קאנייה
Pascual	פאסקואל
Lyman	לימאן
Milford	מילפורד
Francisco	פראנסיסקו
Cornwall	קורנואל
Rossellini	רוסוליני
Perusini	פירוסיני
Constantius	קונסטאנטיוס
Sharbat	שרבאט
Bertoli	בירטולי
Simao	סימאו
Cysteine	סיסטיין
Pascoal	פאסקואל
Smolensk	סמולינסק
Ronde	רונד
Greenwood	גרינווד
Vince	וינס
Schaaf	שאף
Bakhtiar	בכטיאר
Geczi	גקזי
Bernadette	ברנאדיט
Falcao	פאלקאו
Callaghan	קאלאגאן
Ernest	ארנסט
Thaksin	תאקסין
Timothy	טימותי
Cipolla	צ'יפולא
Stefano	סטיפאנו
Dickinson	דיקינסון
Pitesti	פיטיסטי
Palladino	פאלאדינו
Yutaka	יוטאקא
Viswanathan	ויסואנאתאן
Serengeti	סירינגיטי
Opec	אופק
Laurie	לורי
Shamil	שאמיל
Bonner	בונר
Birsk	בירסק
Marmaris	מארמאריס
Kaia	קאיא
Foster	פוסטר
Bosko	בוסקו
Spam	ספאם
Atkinson	אטקינסון
Allam	עלאם
Corneliu	קורניליו
Amnon	אמנון
Repetto	ריפיטו
Jamalzadeh	ג'מאלזאדה
Roy	רוי
Maki	מאקי
Rolland	רולאנד
Ehud	אהוד
Sharma	שארמא
Eshel	אשל
Iii	אייי
Toyotomi	טויוטומי
Chihab	שהאב
Johan	יוהאן
Bulent	בולנט
Hittin	חיטין
Vincenzo	וינצ'ינזו
Denzel	דינזל
Foly	פולי
Jericho	ג'ריקו
Preston	פריסטון
Suha	סוחה
Geir	גיר
Denzil	דינזל
Wayne	ויין
Atopic	אטופיק
Setsubun	סיטסובון
Pelosi	פילוסי
Cosmin	קוזמין
Fouad	פואד
Yuji	יוג'י
Spacey	ספייסי
Persson	פירסון
Shengelia	שינגיליא
Toulalan	טולאלאן
Haddad	חדאד
Koga	קוגא
Bolelli	בולילי
Brecht	ברישט
French	פרינטש
Bahnini	בחניני
Bahadori	בהאדורי
Kantaro	קאנטארו
Bosman	בוסמאן
Halhul	חלחול
Kais	קייס
Idi	עידי
Steed	סטיד
Jody	ג'ודי
Baeyer	באיר
Keketi	קקיטי
Adi	עדי
Steel	סטיל
Humphrey	המפרי
Solana	סולאנא
Kambonde	קאמבונדי
Dunbar	דנבאר
Paillot	פאילוט
Zhang	ז'אנג
Mayne	מיין
Visconti	ויסקונטי
Alnemri	אלנמרי
Omari	עומארי
Polley	פולי
Allouni	עלוני
Ravi	ראבי
Cosgrove	קוסגרוב
Tirnanic	טירנאניטש
Hobeika	חובייקה
Sucha	סושא
Kendrick	קנדריק
Levitsky	לויצקי
Derwall	דירואל
Vorilhon	וורילון
Milutin	מילוטין
Traianos	טראיאנוס
Klimt	קלימט
Hikmat	חקמט
Naysmith	נייסמית
Layne	ליין
Tevez	טיביז
Avril	אבריל
Christiansen	קרישצ'אנסן
Scala	סקאלא
Majstorovic	מאיסטרוביטש
Freier	פרייר
Dahomey	דאהומי
Cheik	שיך
Elst	אלסט
Dohan	דוהאן
Fernandez	פרנאנדיז
Murphy	מירפי
Mercedes	מרסידס
Beer	ביר
Shigeyoshi	שיגיושי
Hutu	הוטו
Fernandes	פירנאנדיז
Kotoku	קוטוקו
Naguib	נגיב
Mutu	מוטו
Duberry	דוברי
Guinness	גיניס
Remetter	רימיטיר
Asi	עאסי
Montpellier	מונפילייה
Faurisson	פוריסון
Joanna	ג'ואנא
Eberhard	אברהארד
Horison	הוריסון
Zeki	זקי
Sukhoi	סוכוי
Bartosz	בארטוש
Wieser	ויזיר
Boyd	בויד
Gimme	גימי
Cocu	קוקו
Basinas	באסינאס
Junger	ג'ונגר
Pegasus	פגאסוס
Gonen	גונן
Barukh	ברוך
Salameh	סלאמה
Piatti	פיאטי
Meskhi	מיסכי
Elrich	אלריטש
Serge	סירג'
Darcy	דארסי
Russell	ראסל
Chomsky	צ'ומסקי
Taksim	טקסים
Solano	סולאנו
Rudolf	רודולף
Euripides	יוריפידיז
Lang	לאנג
Brahem	בראהם
Mettomo	מיטומו
Cafu	קאפו
Masuda	מאסודא
Ayman	איימאן
Hawsawi	האוסאוי
Mil	מיל
Zakariyya	זקריא
Bayoumi	באיומי
Jairzinho	ג'ארזיניו
Commodus	קומודוס
Thomson	טומסון
Ikea	איקיא
Pierino	פיירינו
Ryanair	ראיאנר
Robeson	רובסון
Henedi	הנידי
Munteanu	מונטינו
Quagliarella	קואליארילא
Rogers	רוג'רז
Cheadle	צ'ידל
Chintu	צ'ינטו
Minagawa	מינאגאוא
Clement	קלימנט
Alighieri	אליגיירי
Clair	קלייר
Shankly	שאנקלי
Humssi	חומסי
Belitung	בליטונג
Yefim	יפים
Stephens	סטיפנס
Thant	תאנט
Madruzzo	מאדרוצו
Cocard	קוקארד
Rodolfo	רודולפו
Terim	טירים
Junior	ג'וניור
Henman	הינמאן
Witschge	ויטסטשג
Huard	הוארד
Dakota	דאקוטא
Freeman	פרימאן
Takashi	טאקאשי
Sarandon	סאראנדון
Kruzen	קרוזן
Travian	טראביאן
Blair	בלייר
Rostislav	רוסטיסלאב
Malchiel	מלכיאל
Rani	ראני
Sani	סאני
Lipa	ליפא
Pless	פליס
Touqan	טוקאן
Hani	האני
Hirosue	הירוסו
Mesbah	מסבאח
Zoubeir	זוביר
Nani	נאני
Borel	בורל
Alain	אליין
Linares	לינאריס
Shane	שיין
Dani	דאני
Nakazawa	נאקאזאוא
Graham	גראהאם
Rambutan	ראמבוטאן
Eddie	אדי
Hyam	הים
Hiroaki	הירואקי
Rashed	ראשד
Palladio	פאלאדיו
Gohar	גוהר
Middleton	מידלטון
Cartier	קארטייה
Poulsen	פולסן
Rashid	רשיד
Toshiro	טושירו
Jinyu	ג'יניו
Coeck	קואק
Rourke	רורק
Mobali	מובעלי
Yumi	יומי
Katsav	קצב
Welwyn	וילוין
Minobe	מיינוב
Trek	טריק
Waxman	ואקסמאן
Gaby	גאבי
Emanuel	עמנואל
Chagas	שאגאס
Toshimichi	טושימיטשי
Kumi	קומי
Bartter	בארטר
Reinhart	ריינהארט
Wallach	ואלאך
Taube	טאוב
Horwitz	הורויץ
Ciprian	קיפריאן
Donovan	דונובאן
Saadane	סעדאן
Rasmussen	ראסמוסין
Angkor	אנגקור
Eben	אבין
Rashad	רשאד
Atlas	אטלס
Guanghu	גואנגהו
Larijani	לאריג'אני
Tuncay	טונקיי
Pompeii	פומפיי
Theodor	תיאודור
Som	סום
Tom	טום
Pininfarina	פינינפארינא
Moder	מודר
Mboma	מבומא
Goumas	גומאס
Maksim	מאקסים
Russ	רוס
Menendez	מינינדיז
Theravada	תיראבאדא
Dom	דום
Hafeet	חפיט
Grybauskaite	גריבאוסקאיטי
Shorey	שורי
Rybak	ריבאק
Ninomiya	נינומיא
Gebrselassie	גבריסילאסי
Kapsis	קאפסיס
Amritsar	אמריטסאר
Bratt	בראט
Altai	אלטאי
Alfons	אלפונס
Severus	סיבירוס
Rodion	רודיון
Maltese	מאלטיז
Trabelsi	טראבלסי
Bultmann	בולטמאן
Balkans	באלקאנז
Nowitzki	נוביטסקי
Bratz	בראטז
Skah	סקאח
Renat	רנאט
Uk	אוק
Horemheb	חורמחב
Somerhalder	סומרהאלדר
Carmelo	קארמילו
Vargas	וארגאס
Milano	מילאנו
Martien	מארטין
Heintze	הינצה
Kalifa	חליפה
Kasper	קאספר
Uyghur	ויגור
Guillot	גוילוט
Kaspar	קאספאר
Seaman	סימאן
Karoly	קארולי
Decker	דיקר
Andoni	אנדוני
Vogel	בוגל
Caan	קאן
Collins	קולינז
Younis	יונס
Kohlschreiber	קולשראיבר
Gicquel	גיקיל
Mauricio	מוריסיו
Mellouli	מלולי
Perham	פירהאם
Khayachi	כאיאשי
Guarino	גוארינו
Robson	רובסון
Brenda	ברינדא
Younes	יונס
Bobadilla	בובאדילא
Benedict	בנדיקט
Nicolae	ניקולאי
Haitham	האיתם
Scaloni	סקאלוני
Baltasar	באלטאסאר
Krim	קרים
Otaif	עוטייף
Bueno	בוינו
Hackett	האקיט
Diomansy	דיומאנסי
Younus	יונוס
Benitez	ביניטיז
Aliqulov	עליקולוב
Neveu	נובו
Darby	דארבי
Romina	רומינא
Kerim	קרים
Hussain	חוסיין
Sansom	סאנסום
Hussein	חוסיין
Harare	הרארי
Sturluson	סטרלסון
Becker	בקר
Doesburg	דוסבורג
Albania	אלבניה
Maozhen	מואז'ן
Walter	ואלטר
Cullmann	קולמאן
Knipper	קניפר
Holloway	הולויי
Zeljko	זיליקו
Bomis	בומיס
Roger	רוג'ר
Damon	דאמון
Sugihara	סוגיהארא
Chitou	צ'יטו
Mbia	מביא
Kabongo	קאבונגו
Marius	מאריוס
Duraid	דורייד
Yvon	יבון
Rogen	רוגן
Apolo	אפולו
Hrodna	הרודנא
Kwai	קואי
Erato	אראטו
Tommaso	טומאסו
Vlastimil	ולאסטימיל
Marias	מאריאס
Aldo	אלדו
Risa	ריסא
Minorca	מינורקא
Nevada	ניבאדא
Lisa	ליסא
Dragoslav	דראגוסלאב
Nisa	ניסא
Hathor	חטחור
Merk	מירק
Caravaggio	קאראבאג'יו
Ladbroke	לאדברוק
Zyryanov	זיריאנוב
Canova	קאנובא
Jonas	ג'ונאס
Reynald	רינאלד
Jonah	ג'ונא
Sabrosa	סאברוסא
Prudius	פרודיוס
Illiasu	אליאסו
Yar	יאר
Fredericks	פרידריקס
Salman	סלמאן
Christos	קריסטוס
Par	פאר
Douglass	דוגלאס
Senjuro	סינג'ורו
Zvartnots	זבארטנוטס
Marlee	מארלי
Pascal	פאסקאל
Haider	חידר
Meier	מאיר
Spalletti	ספאליטי
Laguna	לגונה
Gomis	גומיס
Vitruvius	ויטרוביוס
Bar	באר
Jiayi	ג'יאי
Dar	דאר
Etrog	אתרוג
Albi	אלבי
Galton	גאלטון
Arizona	אריזונא
Miljan	מיליאן
Garbo	גארבו
Garba	גארבא
Casper	קאספר
Caspar	קאספאר
Popular	פופיולאר
Ido	אידו
Wachsman	ואקסמאן
Hamaguchi	האמאגוצ'י
Wagner	ואגנר
Alaidy	אלעאידי
Balash	בלאש
Dalglish	דאלגליש
Edo	אידו
Douro	דורו
Nouakchott	נואקשוט
Hatzor	חצור
Enayati	ענאיאטי
Tobias	טובאיאס
Grygera	גריגירא
Diss	דיס
Ruslan	רוסלאן
Rudy	רודי
Hakuho	האקוהו
Daladier	דלאדייה
Wesam	ווסאם
Davidson	דייבידסן
Vukojevic	בוקוביטש
Vagner	ואגנר
Durban	דורבאן
Roudbarian	רודבאריאן
Rayyan	ריאן
Saipan	סאיפאן
Tshabalala	צ'אבאלאלא
Arba	ארבע
Domenghini	דומנגיני
Szarmach	זארמאך
Zaccheroni	זאקירוני
Bidatsu	בידאטסו
Veneto	וניטו
Tomokazu	טומוקאזו
Zucker	זאקר
Kirby	קירבי
Suiko	סויקו
Nefzi	נפזי
Mickey	מיקי
Tassos	טאסוס
Bracciali	בראשיאלי
Montana	מונטאנא
Nefertiti	נפרטיטי
Rousseau	רוסו
Chang	צ'אנג
Seles	סיליש
Cilic	סיליטש
Tarkan	טארקאן
Placido	פלאסידו
Hesse	היסה
Gavriil	גאבריל
Gershon	גרשון
Picasso	פיקאסו
Giordano	ג'ורדאנו
Constantin	קונסטאנטין
Jaidi	ג'אידי
Cannavaro	קאנאבארו
Mile	מיל
Conan	קונאן
Gaspar	גאספאר
Messina	מסינא
Gamarra	גאמארא
Godel	גודל
Strasser	סטראסיר
Maurer	מורר
Dekalim	דקלים
Romulus	רומיולוס
Kazuyoshi	קאזויושי
Cub	קאב
Thon	תון
Kalinic	קאליניטש
Tammet	טאמיט
Young	יונג
Darius	דאריוס
Karrer	קארר
Badoglio	באדוליו
Boole	בול
Firman	פרמאן
Karrar	קראר
Neaman	ניעמאן
Forster	פורסטר
Shahak	שחק
Brasilia	בראזיליא
Seagal	סיגאל
Accademia	אקאדימיה
Saartjie	סארטג'י
Katzir	קציר
Yasunari	יאסונארי
Katzer	קאטזר
Jubayr	ג'ובאיר
Bora	בורא
Muslin	מוסלין
Messi	מסי
Rosetti	רוזיטי
Meade	מיד
Mladinic	מלאדיניטש
Asmara	אסמרא
Broissart	ברויסארט
Berthold	בירתולד
Medan	מידאן
Helen	הלן
Amer	עאמר
Spitzer	ספיצר
Bongani	בונגאני
Kakihara	קאקיהארא
Vojacek	בויאצ'ק
Habash	חבש
Deguerville	דגורביל
Netivot	נתיבות
Wlodzimierz	ולודזמיזירז
Ardahan	ארדאהאן
Hedman	הדמאן
Wunderlich	וונדרליש
Hristov	הריסטוב
Meynieu	מייניו
Dobson	דובסון
Doolittle	דוליטל
Riva	ריבא
Chevanton	שיבאנטון
Masaya	מאסאיא
Selassie	סילאסי
Hadith	חדית
Nicolo	ניקולו
Dominik	דומיניק
Cantabria	קאנטאבריא
Galbraith	גאלבריית
Rutherford	רתרפורד
Nakayama	נאקאיאמא
Goebbels	גובלז
Vyacheslav	ויאצ'יסלאב
Thalia	תאליא
Gentiana	ג'נטיאנא
Aubrey	אוברי
Watson	ואטסון
Matthieu	מאתיו
Maastricht	מאסטריכט
Janowski	ג'אנוסקי
Caligula	קאליגולא
Jesse	ג'סי
Meles	מיליס
Quesnay	קיניי
Lau	לאו
Mckenna	מאקקינא
Weizman	ויצמן
Bau	בו
Almeida	אלמידא
Wilson	וילסון
Buzan	בוזאן
Ayoun	עיון
Bonn	בון
Buzau	בוזאו
Garics	גאריקס
Ramazzotti	ראמאזוטי
Florin	פלורין
Natasa	נאטאסא
Guttmann	גוטמאן
Davidka	דאבידקא
Hidetoshi	הידיטושי
Shapour	שאפור
Segal	סיגאל
Koppel	קופל
Harpo	הארפו
Hatthaporn	האטאפורן
Ponzio	פונזיו
Heine	האינה
Darabont	דאראבונט
Brisson	בריסון
Vercoutre	ורקוטר
Minambres	מינאמבריס
Galahad	גאלאהאד
Bukharin	בוכארין
Holman	הולמאן
Finland	פינלאנד
Bertrand	ברטראנד
Liakhov	ליאקוב
Folke	פולק
Taraneh	טראנה
Vikram	ויקראם
Livingston	ליבינגסטון
Guebuza	גויבוזא
Regan	ריגן
Wladyslaw	ואדיסואב
Yoshiro	יושירו
Takanohana	טאקאנוהאנא
Liotta	לאיוטא
Boc	בוק
Ferrier	פירייה
Bodom	בודום
Zanidpour	זאינאדפור
Cesar	סיזאר
Messier	מסייה
Maeda	מאידא
Guzan	גוזאן
Kenichi	קיניצ'י
Anaheim	אנאהאים
Montand	מונטאן
Barzani	בארזאני
Abduh	עבדוה
Saori	סאורי
Dwyane	דואין
Vytlacil	ויטלאסיל
Ayache	עיאש
Bello	בלו
Caceres	קאסיריס
Borland	בורלאנד
Eastcote	איסטקוט
Urwah	עורוה
Thierry	טיירי
Bodrum	בודרום
Chaeruddin	צ'ארודין
Harald	האראלד
Turpin	טורפין
Ecuador	אקואדור
Zeno	זינו
Jarno	יארנו
Reno	רינו
Suliman	סולימאן
Fojut	פוג'וט
Jawhar	ג'אוהר
Giannini	ג'אניני
Barnet	בארניט
Cordoba	קורדובא
Pound	פאונד
Ford	פורד
Meno	מינו
Hoddle	הודל
Jrme	ג'רם
Abbass	עבאס
Kuszczak	קוצ'אק
Pauleta	פאוליטא
Hiam	היאם
Saud	סעוד
Kerala	קיראלא
Mudingayi	מודינגאי
Liam	ליאם
Kassab	קסאב
Byrd	בירד
Mick	מיק
Yitzhar	יצהר
Bulykin	בוליקן
Maud	מוד
Piquionne	פיקיון
Simeone	סימיוני
Dick	דיק
Cicinho	סיסינהו
Cocis	קוקיס
Belize	בליז
Cathcart	קאתקארט
Friedrich	פרידריק
Suurbier	סורבייר
Martti	מארטי
Millecamps	מיליקאמפס
Xanthopoulos	קזאנתופולוס
Maezono	מייזונו
Dobias	דוביאס
Madjer	מאג'ר
Makoun	מאקון
Fontana	פונטאנא
Damjanovic	דאמיאנוביטש
Frau	פראו
Turkmenistan	טורקמנסיטאן
Lanese	לאניזי
Kyd	קיד
Alfonso	אלפונסו
Frederic	פרידריק
Wittig	ויטיג
Cheb	שב
Coase	קוס
Crockett	קרוקיט
Taupo	טאופו
Batroun	בטרון
Ferguson	פרגוסון
Matthaus	מאטאוס
Carlton	קארלטון
Pogatetz	פוגאטיץ
Coast	קוסט
Djourou	דג'ורו
Irving	אירבינג
Mckimson	מקימסון
Qusay	קוסיי
Lodovico	לודוביקו
Luczak	לוקזאק
Malone	מאלון
Khaldoun	חלדון
Africa	אפריקא
Curtis	קארטיס
Munich	מיוניך
Joel	ג'ול
Manouchehr	מנוצ'הר
Gangnihessou	גאנגניהיסו
Gofman	גופמאן
Wiki	ויקי
Torosidis	טורוסידיס
Kiki	קיקי
Miki	מיקי
Zurn	זורן
Sepp	ספ
Hickersberger	היקרסבירגר
Ciaran	קיאראן
Yoan	יואן
Ralston	ראלסטון
Scofield	סקופילד
Felipe	פיליפי
Hayley	היילי
Shrek	שרק
Benno	בינו
Vladica	ולאדיקא
Bah	באה
Joan	ג'ון
Damme	דאם
Guayana	גויאנא
Ferdi	פירדי
Mclaren	מאקלארין
Barkin	בארקין
Kobi	קובי
Legwinski	ליגבינסקי
Crothers	קרותרס
Berkeley	בירקלי
Belqola	בלקולה
Denshawai	דנשואי
Kaoru	קארו
Andreas	אנדריאס
Curtiss	קורטיס
Kafka	קאפקא
Casimiro	קאזימירו
Vesnin	וסנין
Venetiaan	ויניטיאן
Dreamworks	דרימוורקס
Lancelot	לאנסלוט
Essam	עסאם
Ali	עלי
Lavie	לאבי
Cassian	קאסיאן
Lansing	לאנסינג
Laurent	לורינט
Ludvik	לודביק
Kahane	קאהאנא
Radha	ראדהא
Modigliani	מודיליאני
Ayn	עין
Zubrin	זוברין
Kalusha	קאלושא
Radhi	ראדי
Lurie	לורי
Tobita	טוביטא
Rensenbrink	רינסינברינק
Nouvel	נובל
Butelle	בוטילי
Kolotov	קולוטוב
Sacramento	סאקראמנטו
Domoraud	דומורו
Dervite	דרבייט
Olympus	אולימפוס
Brant	בראנט
Satrapi	סאטראפי
Armand	ארמאנד
Elia	אליא
Kajava	קאיאווא
Hildebrand	הילדבראנד
Victoriano	ויקטוריאנו
Hamilton	האמילטון
Pascani	פאסקאני
Sabri	סאברי
Leitgeb	ליטגיב
Roosevelt	רוזוולט
Malivai	מאליבאי
Sally	סאלי
Deem	דים
Spyridon	ספירידון
Morissette	מוריסיט
Zeila	זילע
Creatine	קריאטין
Okwunwanne	אוקוונואני
Takahashi	טאקאהאשי
Anglia	אנגליא
Kienast	קינאסט
Draco	דראקו
Mumbai	מומבאי
Monteverdi	מונטיבירדי
Monroe	מונרו
Meutstege	מוטסטיג
Polyene	פוליין
Heathrow	היתרו
Sante	סאנטי
Calzada	קאלזאדא
Susan	סוזאן
Santa	סאנטא
Yiannis	יאניס
Susak	סוסאק
Ifil	איפיל
Vlasov	ולאסוב
Santo	סאנטו
Santi	סאנטי
Boulle	בול
Hoshi	הושי
Chamoun	שאמון
Degas	דיגא
Ezer	עזר
Krishna	קרישנא
Scott	סקוט
Henderson	הנדרסון
Bellone	בילוני
Kong	קונג
Bucker	באקר
Nellis	ניליס
Tsunayoshi	טסונאיושי
Caroline	קארולאין
Canterbury	קאנטרברי
Tabucchi	טאבוקי
Philip	פיליפ
Ting	טינג
Gutenberg	גוטנברג
King	קינג
Ling	לינג
Ming	מינג
Bing	בינג
Rejewski	רג'וסקי
Fillion	פיליון
Anderssen	אנדרסן
Locklear	לוקליר
Habre	חברי
Affleck	אפליק
Djelloul	ג'לול
Begag	בגאג
Kesarev	קיסאריב
Tsymbalar	צימבאלאר
Hudson	הודסון
Greenland	גרינלאנד
Karroubi	קארובי
Britain	בריטאן
Almunia	אלמוניא
Silajdzic	סילאידזיטש
Yanagisawa	יאנאגיסאוא
Madani	מדני
Wilmer	וילמר
Bjarni	ביארני
Nasief	נאסיף
Halle	הל
Kedumim	קדומים
Latoundji	לאטונג'י
Dellas	דילאס
Culina	קולינא
Landau	לאנדאו
Vaz	ואז
Cristoforo	קריסטופורו
Contador	קונטאדור
Gentileschi	ג'נטלסקי
Cherry	צ'רי
Sudan	סודאן
Barrau	באראו
Tanizaki	טאניזאקי
Khidiyatullin	חידיאטולין
Moshe	משה
Cardinal	קארדינל
Kila	קילא
Mila	מילא
Billstrom	בילסטרום
Bisset	ביסה
Hutchison	האצ'יסון
Dupas	דופאס
Bila	בילא
Zozimo	זוזימו
Goodman	גודמאן
Pini	פיני
Gila	גילא
Vivaldi	ויואלדי
Nnamdi	נאמדי
Mnajed	מנאג'ד
Rasoul	רסול
Clemence	קלימינס
Zoro	זורו
Mintoff	מינטוף
Braun	בראון
Venezuela	ונזוילא
Dolittle	דוליטל
Highmore	האימור
Thurman	תורמאן
Kallstrom	קאלסטרום
Durix	דוריקס
Curie	קיורי
Tymoshenko	טימושינקו
Alioui	עליוי
Garmendia	גארמנדיא
Zoltan	זולטאן
Tokugawa	טוקוגאוא
Bubnik	בובניק
Yacine	יאסין
Roux	רו
Bak	באק
Koshi	קושי
Burke	בורק
Cargill	קארגיל
Jurkemik	יורקמיק
Molla	מולא
Bigeard	ביגירד
Yukio	יוקיו
Amatzia	אמציה
Raemon	ראימון
Tamboura	טאמבורא
Zinta	זינטא
Corleone	קורליוני
Len	לן
Heylens	היילנס
Christie	קריסטי
Carell	קארל
Knighton	נאיטון
Carretera	קאראטירא
Muzdalifah	מוזדליפה
Rossum	רוסום
Sassi	סאסי
Zuckermann	זאקרמאן
Bertine	ברטין
Lamine	לאמאין
Suarez	סואריז
Viliam	ויליאם
Asaf	עסאף
Belal	בלאל
Grzegorz	גרזיגורז
Slava	סלאבא
Sarr	סאר
Vikash	ויקאש
Abie	אבי
Toomey	טומי
Burkert	בורקרט
Dumbledore	דמבלדור
Kalla	קאלא
Cabrillo	קאברילו
Carr	קאר
Tobin	טובין
Kusao	קוסאו
Kadlec	קאדליץ
Dafna	דפנא
Melora	מילורא
Futon	פוטון
Francini	פראנשיני
Chamot	צ'אמוט
Bruhin	ברוהין
Montagnier	מונטאנייה
Kante	קאנטי
Chester	צ'סטר
Gustavo	גוסטאבו
Alaska	אלאסקא
Sprem	ספרים
Schickard	שיקארד
Kolmogorov	קולמוגורוב
Soskic	סוסקיטש
Tirana	טיראנא
Mervyn	מירבין
Beasley	ביזלי
Mudar	מודאר
Kruger	קרוגר
Bryansk	בריאנסק
Blagoje	בלאגויה
Holstein	הולסטין
Poisson	פואסון
Vlado	ולאדו
Hossam	חוסאם
Voldemort	וולדמורט
Niculae	ניקוליי
Feraoun	פרעון
Nasreddin	נאסראדין
Adib	אדיב
Kyros	קירוס
Lancashire	לאנקשיר
Docherty	דוקירטי
Samsun	סאמסון
Nissan	ניסאן
Guiscard	גיסקארד
Quebec	קויביק
Frankfurt	פראנקפורט
Yevriuzhikin	יבריוז'יקין
Tawil	טוויל
Rainer	ראינר
Rouissi	רויסי
Dahl	דאל
Sharif	שריף
Samson	סאמסון
Jeremy	ג'רמי
Bouna	בונא
Weill	ויל
Husni	חוסני
Nicolai	ניקולאי
Derdiyok	דרדיוק
Mauro	מאורו
Salenko	סאלינקו
Holt	הולט
Henriette	הנרייט
Montessori	מונטיסורי
Reynaud	רינו
Somekh	סומך
Carbajal	קארבאכאל
Bolt	בולט
Colt	קולט
Maura	מורא
Zico	זיקו
Jussi	יוסי
Propane	פרופיין
Richthofen	רישטהופן
Rico	ריקו
Ferrari	פירארי
Takagi	טאקאגי
Yushchenko	יושצ'נקו
Myojin	מיוג'ן
Lauro	לאורו
Nico	ניקו
Ferruccio	פירוצ'יו
Hirata	היראטא
Maillart	מאילארט
Sokolov	סוקולוב
Bornstein	בורנסטאין
Szeged	זיגיד
Laura	לורא
View	ויו
Kramer	קריימר
Parrish	פאריש
Dusan	דוסאן
Aarhus	ארהוס
Indiana	אינדיאנא
Evra	איברא
Shay	שי
Estili	אסטילי
Cheyrou	צ'יירו
Talal	טלאל
Sakurai	סאקוראי
Dalli	דאלי
Constans	קונסטנס
Leucine	לוסין
Mouloud	מולוד
Hull	הל
Hamsun	המסון
Lulea	לוליא
Dante	דאנטה
Wes	וס
Tanta	טנטא
Siti	סיטי
Les	לס
Ballmer	באלמר
Pasqual	פאסקואל
Aes	איס
Tucci	טוצ'י
Hunt	האנט
Coleman	קולמאן
Reuven	ראובן
Iraqi	עיראקי
Weissglass	וייסגלאס
Scotty	סקוטי
Transat	טראנסאט
Xucuru	זוקורו
Hogan	הוגאן
Okazaki	אוקאזאקי
Francis	פראנסס
Micoud	מיקו
Feinstein	פיינשטיין
Kawasumi	קאואסומי
Zhenyu	ז'יניו
Nistelrooy	ניסטלרוי
Kuhn	קון
Houbara	חובארא
Belmondo	בלמונדו
Patience	פיישאנס
Rolfes	רולפס
Poincare	פואנקארה
Imamura	אימאמורא
Tir	טיר
Reinhold	ראינהולד
Ornella	אורנילא
Utada	אוטאדא
Nir	ניר
Zenata	זנאטה
Wieghorst	ויהורסט
Ennio	אניו
Gauguin	גוגן
Gosho	גושו
Juarez	ואריז
Moreno	מורינו
Arnon	ארנון
Hampden	האמפדן
Giampiero	ג'אמפיירו
Merneptah	מרנפטאח
Willi	וילי
Sauvage	סובאג'
Lively	לאיבלי
Ginaton	גינתון
Kosin	קוסין
Eurosport	איורוספורט
Scholl	שול
Pelton	פילטון
Piero	פיירו
Vojvodina	בויבודינא
Kurt	קורט
Gennaro	גנארו
Iraq	עיראק
Stade	סטאד
Braille	בריاל
Shapira	שאפירא
Shakib	שאקיב
Greeley	גרילי
Coluna	קולונא
Galli	גאלי
Villa	וילא
Johnson	ג'ונסון
Renschler	רנשלר
Vilnius	וילניוס
Metzelder	מצלדר
Galla	גאלא
Laudrup	לאודרופ
Zaccarelli	זאקארילי
Constable	קונסטאבל
Hubble	האבל
Frontera	פרונטירא
Sergio	סרג'יו
Ephraim	אפרים
Debye	דבי
Ahmad	אחמד
Skorzeny	סקורזיני
Daewoo	דאיוו
Basescu	באסיסקו
Budan	בודאן
Herodias	הירודיאס
Panagoulias	פאנאגוליאס
Milla	מילא
Gavriel	גבריאל
Falla	פאלא
Eskisehir	איסקיסיהיר
Rakhsh	ראכש
Saionji	סאיונג'י
Taimanov	טאימאנוב
Lilly	לילי
Lupatelli	לופאטילי
Clovis	קלוביס
Ira	אירא
Ofer	אופר
Roudolphe	רודולף
Tennant	טינאנט
Stone	סטון
Mudrik	מודריק
Alexandrina	אלקסאנדרינא
Fanta	פאנטא
Lilli	לילי
Moya	מויא
France	פראנס
Lille	ליל
Verner	ורנר
Hadj	חאג'
Sao	סאו
Tao	טאו
Stallone	סטאלון
Rivaldo	ריבאלדו
Roddick	רודיק
Cugnot	קוניו
Wilhelmshaven	וילהלמסהייבן
Tereshkova	טרשקובא
Filippo	פיליפו
Leuven	לובין
Lockheed	לוקהיד
Rand	ראנד
Yoann	יואן
Taborda	טאבורדא
Toulon	טולון
Bubka	בובקא
Trenton	טרינטון
Bugnet	בוגניט
Philippe	פיליפ
Baroud	בארוד
Samassi	סאמאסי
Bocelli	בוצ'לי
Sidwell	סידויל
Landry	לאנדרי
Schroder	שרודר
Chaabo	שעבו
Maddalena	מאדאלינא
Zimmer	זימר
Graafschap	גראפשאפ
Selten	סלטן
Edmund	אדמונד
Fiore	פיורי
Petra	פיטרא
Shih	שיה
Chiellini	קייליני
Christy	קריסטי
Hauptmann	האופטמאן
Souness	סוניס
Perrin	פירין
Smolarek	סמולאריק
Rosti	רוסטי
Bunton	באנטון
Herold	הרולד
Nabatame	נאבאטאמי
Baljic	באליטש
Bouboulina	בובולינא
Romulo	רומולו
Kata	קטע
Phillip	פיליפ
Dmitriy	דמיטרי
Dorji	דורג'י
Nyandoro	ניאנדורו
Alona	אלונא
Bogota	בוגוטא
Napoleon	נאפליון
Jalal	ג'לאל
Ned	נד
Rammal	רמאל
Grigore	גריגורי
Qasim	קאסים
Wight	ואיט
Luol	לואל
Mononoke	מונונוק
Lev	לב
Sherwood	שרווד
Davinio	דאוויניו
Veselinovic	ויסילינוביטש
Herda	הירדא
Stelios	סטיליוס
Naji	נאג'י
Morishima	מורישימא
Mill	מיל
Shaka	שאקא
Tranquillo	טראנקוילו
Zurer	זורר
Naples	נאפלס
Bommer	בומר
Albaath	אלבעת
Geresh	גרש
Liedholm	לידהולם
Korolyov	קורוליוב
Mansare	מאנסארי
Chiune	צ'יונה
Sonny	סוני
Haruki	הארוקי
Dawid	דאויד
Kazenga	קאזינגא
Qurei	קוריע
Bixente	ביסינטי
Frings	פרינגז
Georgescu	ג'ורג'סקו
Olivier	אוליבייר
Muhren	מוהרן
Rolff	רולף
Mersenne	מירסין
Faure	פורי
Niccolo	ניקולו
Verdi	וורדי
Liu	לו
Lasker	לאסקר
Escobar	אסקובאר
Pisa	פיזא
Toshiba	טושיבא
Barcham	ברצ'ם
Ronny	רוני
Verde	ורדי
Mollemann	מולימאן
Lowry	לאורי
Lerond	לירונד
Panandetiguiri	פאנאנדיטיגוירי
Tarawa	טאראוא
Teresa	טיריזא
Perutz	פירוץ
Vieri	ויירי
Harakat	חרקת
Garrincha	גארינשא
Herve	הירבה
Miladinovic	מילאדינוביטש
Diffie	דיפי
Moldova	מולדובא
Podolski	פודולסקי
Tamil	טאמיל
Tiasse	טיאסי
Maillol	מאיול
Mcenroe	מאקנרו
Cent	סנט
Bahr	בחר
Dekker	דיקר
Samir	סמיר
Trapani	טראפאני
Marley	מארלי
Renault	רינולט
Worm	וורם
Crespo	קריספו
Botton	בוטון
Mbida	מבידא
Boreanaz	בורינאז
Adidas	אדידס
Gianluca	ג'אנלוקא
Lavrov	לאברוב
Giamatti	ג'אמאטי
Snorri	סנורי
Acosta	אקוסטא
Mazut	מאזוט
Laurence	לורנס
Payton	פייטון
Schnabel	שנאבל
Watt	ואט
Besson	בסון
Martov	מארטוב
Cools	קולז
Matt	מאט
Pollard	פולארד
Billy	בילי
Romain	רומיין
Silwan	סילואן
Augusta	אוגוסטא
Subaru	סובארו
Saldana	סאלדאנא
Mukerji	מוקרג'י
Kazantzakis	קאזאנצאקיס
Spacek	ספייסק
Connes	קן
Rafael	רפאל
Ang	אנג
Vaziri	וזירי
Okko	אוקו
Sudarsono	סודארסונו
Belaid	בילייד
Evander	איבאנדר
Stielike	סטיליקה
Pacheco	פאצ'קו
Pompidou	פומפידו
Tayeb	טייב
Palma	פאלמא
Romuald	רומאלד
Palme	פאלם
Saad	סעד
Jennings	ג'נינגז
Mimouna	מימונה
Adrian	אדריאן
Sowe	סו
Pastan	פאסטאן
Maceio	מאסיו
Kateryna	קאטרינא
Reija	ריכא
Thani	תאני
Mosaddeq	מוסאדק
Cerf	סירף
Sabah	סבאח
Gillo	גילו
Shirai	שיראי
Forlan	פורלאן
Simonetta	סימוניטא
Hyori	היורי
Feridun	פרידון
Navon	נבון
Talaat	טלעט
Berkman	בירקמאן
Capone	קאפונ
Nordstrom	נורדסטרום
Ingeborg	אינגיבורג
Raffaele	רפאלי
Chakib	שקיב
Capcom	קאפקום
Kristanna	קריסטאנא
Herodotus	הירודוטוס
Jencks	ג'נקס
Martha	מארתא
Tessho	טישו
Krul	קרול
Marouane	מרואן
Bynes	בינז
Brul	ברול
Kropotkin	קרופוטקין
Mutal	מוטאל
Murdoch	מורדוק
Pharaon	פרעון
Zarko	זארקו
Yakov	יעקב
Aljabal	אלג'בל
Carlyle	קארלאיל
Zemin	זימין
Simple	סימפל
Caravelli	קראבילי
Cosby	קוסבי
Guerin	גוארין
Tefilo	טפילו
Anselm	אנסילם
Trezeguet	טריזיגה
Saberi	סאברי
Kei	קיי
Lei	ליי
Jonny	ג'וני
Hayez	האיז
Jaziri	ג'זירי
Rabuel	ראבואל
Jawed	ג'אווד
Hasan	חסן
Fei	פיי
Hayes	הייז
Judt	ג'ודט
Feingold	פאינגולד
Hayek	חאיק
Talabani	טאלבאני
Eleanor	אלאנור
Torquato	טורקואטו
Machlas	מאצ'לאס
Kenzaburo	קנזאבורו
Cemal	ג'מאל
Govedarica	גובידאריקא
Hendel	הנדל
Degen	דיגן
Parks	פארקס
Shustikov	שוסטיקוב
Zaghloul	זגלול
Shahnameh	שאהנאמה
Bonnard	בונארד
Nicanor	ניקאנור
Angela	אנגילא
Noble	נובל
Cobeno	קובינו
Iglesias	איגליסיאס
Busacca	בוסאקא
Weitz	ויץ
Costa	קוסטא
Denisov	דיניסוב
Zisis	זיסיס
Lassalle	לאסאל
Rikiya	ריקיא
Micrometre	מיקרומטר
Fognini	פוניני
Ledesma	לידיסמא
Fiqh	פיק
Minavand	מינאואנד
Islam	איסלאם
Sedna	סידנא
Benedictine	בינידיקטין
Byrne	בירן
Revelle	רבל
Schwartz	שוארץ
Yoshinaka	יושינאקא
Skopje	סקופיי
Drissa	דריסא
Nawel	נואל
Xiaoxu	שיאושו
Tsuboi	טסובוי
Swayze	סוייזי
Duchovny	דוכובני
Lamport	לאמפורט
Pantoliano	פאנטוליאנו
Oti	אוטי
Mayer	מאיר
Tbilisi	טביליסי
Constanze	קונסטנזא
Kathleen	קאתלין
Aosta	אוסטא
Mendel	מנדל
Teodor	טיודור
Snoop	סנופ
Solymosi	סולימוסי
Papua	פאפוא
Boselli	בוסיללי
Thabit	תאבט
Duvalier	דובאלייה
Houssine	חוסין
Zakharov	זאכארוב
Laban	לבן
Zaidan	זאידן
Muhammed	מוחמד
Yasuo	יאסו
Safranek	סאפראניק
Rijkaard	ריקארד
Dropsy	דרופסי
Apollinaire	אפולינייר
Karazon	קאראזון
Schmolck	שמולק
Pekerman	פקרמאן
Vance	ואנס
Bisson	ביסון
Zewlakow	זולאקו
Donna	דונא
Assoumani	עסומאני
Bahrain	בחריין
Borriello	בוריילו
Reiser	רייזר
Reichstein	ראיכשטאין
Atahualpa	אטאואלפא
Kerckhoffs	קירקהופס
Bharrat	באראט
Shawqi	שאוקי
Ayrshire	אירשאיר
Tenji	טינג'י
Raja	רג'א
Savio	סאביו
Sylla	סילא
Cappadocia	קאפאדוקיא
Mommsen	מומסן
Raviv	רביב
Fausto	פאוסטו
Mabrouk	מברוק
Sarhan	סרחאן
Barakat	ברקאט
Avram	אברם
Hangeland	האנגילאנד
Stephon	סטיפן
Keith	קית
Somalia	סומאליה
Brandt	בראנט
Constanta	קונסטאנטא
Goulon	גולון
Keita	קייטא
Vlaovic	וולאוויטש
Lawrence	לורנס
Elbaradei	אלבראדעי
Nasib	נסיב
Shapur	שאפור
Yaakov	יעקוב
Benaglio	בינאגליו
Grenville	גרנביל
Zoe	זואי
Irvine	אירבאין
Nasim	נסים
Chtaura	שטורה
Majed	מג'ד
Nasir	נאסיר
Romania	רומייניה
Franck	פראנק
Taisho	טאישו
Malmo	מאלמו
Hiroshi	הירושי
Szentmihalyi	סזינטמיהאלי
Tueni	טויני
Pandora	פאנדורא
Tarzan	טרזאן
Katsouranis	קאטסוראניס
Perry	פירי
Hundertwasser	הונדרטוואסר
Cabanas	קאבאנאס
Chiacchio	צ'יאקיו
Mendoza	מנדוזא
Galletti	גאליטי
Mkhalele	מכאללה
Emma	אימא
Kapitsa	קאפיטסא
Andriy	אנדרי
Hector	היקטור
Kettering	קיטירינג
Handel	האנדל
Tamer	טאמר
Malawi	מאלאוי
Zakuani	זאקואני
Martinelli	מארטינילי
Monterroso	מונטירוסו
Deplace	דיפלאס
Stoichkov	סטויצ'קוב
Pjanic	פיאניטש
Mel	מל
Lacombe	לאקומב
Beyonce	ביונסי
Biaggio	ביאג'יו
Del	דיל
Cavenaghi	קאוונאגי
Deedat	דידאט
Baruch	ברוך
Suvari	סובארי
Maddah	מדאח
Chopin	שופאן
Matar	מטר
Stari	סטארי
Ezzaki	אזאקי
Stark	סטארק
Samer	סאמר
Birtles	בירטלז
Lineker	ליניקר
Shawarma	שאורמא
Franklin	פראנקלין
Eleftherios	אליפתיריוס
Nicholas	ניקולאס
Basil	באסל
Proyas	פרויאס
Smits	סמיטס
Falintil	פאלינטיל
Tengiz	טינגיז
Clare	קלייר
Clara	קלארא
Rik	ריק
Vreijsen	וריסן
Vik	ויק
Hediger	הדיגר
Nancy	נאנסי
Clark	קלארק
Ponzi	פונזי
Nik	ניק
Platko	פלאטקו
Minoru	מינורו
Khurtsilava	חורטסילאבא
Solhi	סולחי
Terry	טירי
Ahern	אהירן
Chagall	שאגאל
Saiga	סאיגא
Ternopil	טרנופיל
Randall	ראנדאל
Marks	מארקס
Katan	קטן
Marko	מארקו
Jaloo	ג'אלו
Montez	מונטיז
Cincinnati	סינסינאטי
Florida	פלורידא
Mehdi	מהדי
Calatrava	קאלאטראבא
Vila	וילא
Men	מן
Lerdorf	לרדורף
Valentin	عאלנטין
Dayton	דייטון
Serra	סירא
Scotland	סקוטלאנד
Turan	טוראן
Hamer	האמר
Corluka	קורלוקא
Savicevic	סאביצ'ביטש
Bayer	באיר
Eduard	אדוארד
Disney	דיזני
Miescher	מישר
Gren	גרין
Kenji	קנג'י
Durrell	דאריל
Shimla	שימלא
Hamed	חאמד
Jellinek	יליניק
Darmian	דארמיאן
Alex	אלקס
Jeonghui	ג'יונגהוי
Rapaic	ראפאייטש
Bajram	באירם
Finn	פין
Charpenet	צ'ארפיניט
Velzquez	ולאזקיז
Sumter	סומטר
Guadiana	גואדיאנא
Swank	סואנק
Antonius	אנטוניוס
Rotblat	רוטבלאט
Katsu	קאטסו
Rodolphe	רודולף
Sigmund	סיגמונד
Henrique	הנריקה
Held	הילד
Tornatore	טורנאטורי
Avro	אברו
Pearson	פירסון
Laroui	לערוי
Idris	אידריס
Gildas	גילדאס
Feld	פילד
Takuya	טאקויא
Bogdan	בוגדאן
Harrell	הארל
Dora	דורא
Poti	פוטי
Shays	שייז
Mokdad	מוקדאד
Svetlana	סביטלאנא
Heintje	האין
Sahraoui	סחראוי
Karoui	קרוי
Moti	מוטי
Kunishige	קונישיגי
Zhirkov	ז'ירקוב
Jermain	ג'רמיין
Claudette	קלודט
Kadeer	קדיר
Leonel	ליונל
Dwayne	דויין
Hitzfeld	היצפילד
Monaghan	מונאגאן
Bajer	באיר
Amira	אמירה
Wilhelm	וילהלם
Crayston	קרייסטון
Hosokawa	הוסוקאוא
Takumi	טאקומי
Fayed	פאיד
Natacha	נאטאשא
Jamuovandu	ג'אמובאנדו
Fayez	פאיז
Maidin	מאידן
Horowitz	הורוביץ
Ethylene	אתילין
Habermas	האברמאס
Bork	בורק
Nathanson	נייתנסון
Pfannkuch	פפאנקוטש
Arar	עראר
Theo	תיו
Leighton	לייטון
Fareed	פריד
Chafik	שפיק
Ruddy	רודי
Slobodan	סלובודאן
Anelka	אנילקא
Dougray	דוגריי
Zondervan	זונדרבאן
Assi	עאסי
Jacky	ג'קי
Maiga	מאיגא
David	דייוויד
Walker	ואלקר
Kamel	קאמל
Dorfner	דורפנר
Kamen	קאמן
Kamei	קאמיי
Buta	בוטא
Balta	באלטא
Upton	אפטון
Crichton	קריקטון
Zaki	זקי
Hubbard	הובארד
Hofstadter	הופשטאדטר
Califf	קאליף
Harris	האריס
Durant	דוראנט
Duncan	דנקאן
Indyk	אינדיק
Jo	ג'ו
James	ג'יימז
Leo	ליאו
Aghahowa	אגאהווא
Wyatt	ואיאט
Reina	ריינא
Rasul	רסול
Drioton	דריוטון
Gogol	גוגול
Kouyoumdjian	קויומגיאן
Vitali	ויטאלי
Zvonimir	זבונימיר
Fouhami	פוהאמי
Clemente	קלימנטי
Schally	סקאלי
Pompilius	פומפיליוס
Turk	טורק
Piaui	פיאוי
Seifert	סיפירט
Scola	סקולא
Telemann	טילימאן
Waksman	ואקסמאן
Heinz	היינז
Dourif	דוריף
Griffith	גריפית
Kidman	קידמאן
Westmoreland	וסטמורלאנד
Lawal	לאואל
Jacobi	ג'אקובי
Bertie	בירטי
Kulthum	קלתום
Jerry	ג'רי
Tajalli	טג'לי
Heini	היני
Mitanni	מיטאני
Trujillo	טרוג'ילו
Bradley	בראדלי
Avnei	אבני
Deisler	דאיסלר
Tabari	טברי
Skoblar	סקובלאר
Barka	ברקה
Asror	אסרור
Leib	ליב
Avner	אבנר
Angeles	אנג'ליס
Eminem	אימינם
Grazia	גראזיא
Vicelich	ויסליטש
Kawai	קאואי
Yugoslavia	יוגוסלאביא
Toshiyuki	טושיוקי
Andersen	אנדרסן
Kemoko	קימוקו
Lobont	לובונט
Oster	אוסטר
Dramani	דראמאני
Marlborough	מארלבורו
Ayalon	אילון
Quasimodo	קואזימודו
Yuzo	יוזו
Stroustrup	סטרוסטרופ
Komora	קומורא
Capua	קאפוא
Puzo	פוזו
Nativ	נתיב
Bert	ברט
Larcher	לארשה
Sassari	סאסארי
Gavin	גאבן
Golbourne	גולבורן
Kalmykia	קאלמיקיא
Pol	פול
Talib	טאלב
Feodor	פיודור
Niklas	ניקלאס
Buhturi	בוחטורי
Willard	וילארד
Richelieu	רישיליו
Rimet	רימיט
Herget	הרגט
Cossou	קוסו
Olympias	אולימפיאס
Ricki	ריקי
Dozy	דוזי
Baroti	בארוטי
Salif	סאליף
Nekounam	נקונאם
Litzman	ליצמאן
Stankovic	סטאנקוביטש
Liviu	ליביו
Grosjean	גרוסג'ין
Altman	אלטמאן
Livio	ליוויו
Rajab	רג'ב
Camel	קאמל
Lyudmila	לודמילא
Ponaryo	פונאריו
Kaimbi	קאימבי
Coelho	קואלו
Mirko	מירקו
Montevideo	מונטיבידיו
Hanoi	האנוי
Golding	גולדינג
Fargeon	פארגיון
Neal	ניל
Pollock	פולוק
Osho	אושו
Gerson	גרסון
Millard	מילארד
Yamaguchi	יאמאגוצ'י
Gueye	גויי
Royal	רויאל
Mehmet	מחמט
Stella	סטילא
Nawaz	נאואז
Cheikh	שיך
Coulibaly	קוליבאלי
Kyle	קאיל
Chanel	צ'אנל
Caracas	קאראקאס
Tubman	טובמאן
Dainelli	דאינילי
Havana	האבאנא
Hind	הינד
Garzon	גארזון
Edouard	אדוארד
Abbas	עבאס
Sie	סי
Tie	טאי
Wilkshire	וילקשיר
Sox	סוקס
Fleihan	פליחאן
Djorkaeff	דג'ורקאייף
Vicky	ויקי
Neumann	נוימאן
Fangzhuo	פאנגז'ו
Cox	קוקס
Makarios	מקאריוס
Ettore	איטורי
Dhyna	דיאנא
Benneteau	בניטו
Halil	הליל
Kokoschka	קוקושקא
Rous	רוס
Yekaterinburg	יקאטרינברג
Lualua	לואלוא
Togashi	טוגאשי
Majalli	מג'לי
Philadelphia	פילאדלפיא
Beckham	בקהאם
Topher	טופר
Rembrandt	רמבראנט
Ander	אנדר
Pirandello	פיראנדילו
Berri	ברי
Mcdaniel	מקדאניאל
Kondratiev	קונדראטייב
Brazauskas	בראזאוסקאס
Saree	סארי
Tiberias	טאיביריאס
Fradique	פראדיק
Pape	פאפי
Storari	סטורארי
Jason	ג'ייסן
Zion	זאיון
Bernardino	ברנארדינו
Berry	בירי
Dinara	דינארא
Helt	הילט
Kanoute	קאנוטי
Prodi	פרודי
Roeder	רודר
Hilditch	הילדיטש
Verdasco	ורדאסקו
Mortensen	מורטינסין
Kunert	קונרט
Fouine	פוין
Brunetti	ברוניטי
Aurelius	אוריליוס
Leterrier	לטרייר
Mhlongo	מהלונגו
Hansard	האנסארד
Etna	אטנא
Kemp	קמפ
Fethi	פטחי
Tommy	טומי
Sylvester	סילבסטר
Marquez	מארקיז
Labaki	לאבאקי
Bryant	בראינט
Nwankwo	נואנקו
Vujicic	ביוטיטש
Student	סטודנט
Malin	מאלין
Mamady	מאמאדי
Malik	מאליק
Cryptozoology	קריפטוזואולוג'י
Bjorkman	ביורקמאן
Breitner	בראיטנר
Holodomor	הולודומור
Bauhin	בוהין
Marcia	מארסיא
Janos	יאנוש
Uchida	אוצ'ידא
Trafalgar	טראפאלגאר
Mischa	מישא
Soren	סורין
Kone	קוני
Gerry	גירי
Deir	דיר
Rmaich	רמייש
Belin	בילין
Slavkov	סלאבקוב
Annan	ענאן
Farrell	פאריל
Jarkko	יארקו
Ferri	פירי
Nigeria	נאיג'יריא
Wellhausen	ולהאוזן
Ryedale	ראידיל
Trejo	טריג'ו
Lescott	ליסקוט
Goring	גורינג
Pakistan	פאקיסטאן
Kalabane	קאלאבאן
Traian	טראיאן
Runje	רונג'י
Kilambe	קילאמבי
Steele	סטיל
Aharon	אהרון
Bitat	ביטאט
Theiler	טילר
Polo	פולו
Bitar	ביטאר
Tddaiji	טדאיג'י
Etienne	אטיין
Britney	בריטני
Robbins	רובניז
Ogogo	אוגוגו
Kolo	קולו
Pontoppidan	פונטופידאן
Euglena	יוגלינא
Bastian	באסטיאן
Vartan	וארטאן
Abud	עבعד
Meliton	מיליטון
Slimane	סלימאן
Haggai	חגי
Melamed	מלמד
Pitt	פיט
Ritt	ריט
Ramesses	רמסיס
Witt	ויט
Marton	מארטן
Druze	דרוז
Mitt	מיט
Hejlsberg	הילסברג
Martin	מארטן
Seidath	סיידאת
Makoto	מאקוטו
Colleter	קולטר
Nicky	ניקי
Gjirokaster	גירוקאסטר
Mizushima	מיזושימא
Strontium	סטרונטיום
Hozumi	הוזומי
Zlatko	זלאטקו
Hippolyte	היפוליט
Heinrich	הינריך
Najah	נג'אח
Bosch	בוש
Satyajit	סאטיאג'יט
Suvorov	סובורוב
Joji	ג'וג'י
Koji	קוג'י
Isidore	איזידור
Keisuke	קיסוקה
Maslow	מאסלו
Narriman	נארימאן
Ziad	זיאד
Interpol	אינטרפול
Orlandoni	אורלאנדוני
Riad	ריאד
Flores	פלוריס
Feliu	פילאיו
Choutos	צ'וטוס
Merbah	מרבאח
Sorensen	סורינסן
Rony	רוני
Sony	סוני
Traoui	טראוי
Shimomura	שימומורא
Bsharri	בשארי
Cahill	קאהיל
Bernal	ברנאל
Behzadi	בהזאדי
Vasarely	ואסארלי
Zelenka	זילינקא
Davala	דאואלא
Shawkat	שאוקאט
Martins	מארטינז
Seeler	סילר
Paille	פייל
Martens	מארטינז
Mandy	מאנדי
Nikos	ניקוס
Brahman	בראהמאן
Orwell	אורויל
Viet	וייט
Eitan	איתן
Eitam	איתם
Lazaroni	לאזארוני
Mohs	מוס
Melinda	מלינדא
Loren	לורין
Colorado	קולוראדו
Dalia	דאליא
Harrison	האריסון
Yukino	יוקינו
Maik	מאיק
Natsume	נאטסומה
Mcdermott	מקדירמוט
Irkutsk	אירקוטסק
Calvin	קאלוין
Wordsworth	וורדזוורת
Randolph	ראנדולף
Malouda	מאלודא
Parietti	פאריאטי
Penh	פן
Claire	קלייר
Sanogo	סאנוגו
Nesterov	נסטרוב
Dion	דיון
Quinn	קוין
Koren	קורן
Jaroslaw	יארוסלו
Case	קייס
Tachiki	טאטשיקי
Roman	רומאן
Korea	קוריא
Montale	מונטאלי
Blaine	בליין
Queensland	קוינסלאנד
Ami	עאמי
Vojtech	בויטיטש
Dirani	דיראני
Santillana	סאנטילאנה
Hamsa	המסה
Kiichiro	קיטשירו
Blaise	בלייז
Lubitsch	לוביטש
Julien	גול'יאן
Hijab	ח'יגאב
Morgan	מורגן
Hitchcock	היצ'קוק
Domeyko	דומייקו
Makassar	מאקאסאר
Lanark	לאנאנרק
Clapton	קלאפטון
Heisenberg	הייזנבירג
Serpentinite	סרפנטינאיט
Capparoni	קאפארוני
Kilmer	קילמר
Jankovic	יאנקוביטש
Bagheri	באגרי
Ilkhanate	אלכאנאט
Alton	אלטון
Minot	מינוט
Maybach	מייבאך
Painton	פיינטון
Moraru	מורארו
Vijay	ויג'יי
Zucchero	זוקירו
Tim	טים
Kela	קילה
Meireles	מירילס
Nasyrow	נסירוב
Yade	יאד
Renones	רינוניס
Jim	ג'ים
Kim	קים
Lenz	לינז
Tursunov	טורסנוב
Galvin	גאלבין
Sheetrit	שטרית
Nacer	נאסר
Benz	בנז
Rhodesia	רודיסיא
Moravia	מוראביא
Pretoria	פריטוריא
Sucre	סוקר
Bering	בירינג
Shahab	שהאב
Koyama	קויאמא
Kareem	קרים
Brooks	ברוקס
Histadrut	הסתדרות
Salata	סאלאטה
Zambrotta	זאמברוטא
Stranzl	סטראנזל
Galil	גליל
Valdano	ואלדאנו
Nagui	נאגי
Galic	גאליק
Kerlon	קירלון
Wiesel	ויסל
Garcia	גארסיא
Unilever	יוניליבר
Mezey	מיזי
Salama	סלאמה
Sluiter	סלויטר
Galis	גאליס
Rothbard	רותבארד
Chauveau	שובו
Gasquet	גאסקה
Luigi	לויג'י
Murdock	מרדוק
Alshahid	אלשהיד
Alalwani	אלעלואני
Sofer	סופר
Valcareggi	ואלקארידג'י
Maccoby	מאקובי
Fournier	פורנייר
Luce	לוס
Tampere	טאמפירי
Reed	ריד
Teresina	טיריסינא
Mobius	מוביוס
Hernandez	הרנאנדיז
Zapata	זאפאטא
Goldwater	גולדווטר
Batteux	באטו
Frisch	פריש
Senna	סינא
Rami	ראמי
Bahamas	באהאמאס
Dabo	דאבו
Zerhouni	זרהוני
Mireille	מיריי
Mikko	מיקו
Blanchett	בלאנצ'ט
Syktyvkar	סיקטיבקאר
Yomi	יומי
Americana	אמריקאנא
Elton	אלטון
Barranquilla	באראנקוילא
Maslyonkin	מאסליונקן
Bertoni	בירטוני
Rastafari	ראסטאפארי
Bertini	ברטיני
Yannick	יאניק
Pana	פאנא
Qana	קאנא
Datsakorn	דאטסאקורן
Lynch	לינץ'
Barenboim	בארינבוים
Fitzgerald	פיצג'ראלד
Hana	הנא
Fumimaro	פומימארו
Jana	יאנא
Serao	סיראו
Lana	לאנא
Gomes	גומיז
Giancarlo	ג'אנקארלו
Koman	קומאן
Alaam	עאלם
Annie	אני
Dana	דאנא
Gregorio	גריגוריו
Corey	קורי
Proust	פרוסט
Hidd	חיד
Maryam	מריאם
Kidd	קיד
Hestia	הסטיא
Kroldrup	קרולדרופ
Rahel	ראחיל
Walaza	ואלאזא
Tanzan	טאנזאן
Buell	ביואל
Zeev	זיו
Deflandre	דיפלאנדר
Rimini	רימיני
Cravero	קראבירו
Zuma	זומא
Jezek	יזיק
Mussolini	מוסוליני
Joaquin	ג'ואקין
Merom	מרום
Bamrung	באמרונג
Yamashita	יאמאשיטא
Managua	מאנאגוא
Lizarazu	ליזאראזו
Diamoutene	דיאמוטין
Salk	סולק
Berkshire	בירקשיר
Tullio	טוליו
Numa	נומא
Viking	ואיקינג
Tayseer	טאיסיר
Kurzweil	קרזוייל
India	אינדיא
Besant	ביזנט
Deisenhofer	דאיזנהופר
Transkei	טראנסקיי
Bamlett	באמלט
Wawrzyniak	ואורזניאק
Faraday	פאראדאי
Hans	האנס
Weah	ויא
Sezen	סיזין
Manfredonia	מאנפרידוניא
Leah	ליה
Shahd	שאד
Jiechi	ג'יצ'י
Cave	קייב
Dave	ייב
Geraldine	ג'ראלדין
Jonbenet	ג'ונביניט
Gassid	גאסיד
Tabarez	טאבארז
Naqqash	נקאש
Dinos	דינוס
Goren	גורן
Leiden	לידין
Nippon	ניפון
Coundoul	קונדול
Robin	רובן
Rickman	ריקמאן
Martinez	מארטיניז
Brody	ברודי
Nakasone	נאקאסונה
Mcmillan	מאקמילאן
Dorian	דוריאן
Fourier	פורייר
Maillet	מיילט
Atlantic	אטלאנטיק
Jettou	ג'טו
Calexico	קאליקסיקו
Kensington	קנסינגטון
Slim	סלים
Sato	סאטו
Mikati	מיקאטי
Bergius	בירגיוס
Mikari	מיקארי
Rehavam	רחבעם
Nakagawa	נאקאגאוא
Coupet	קופה
Mato	מאטו
Nato	נאטו
Shore	שור
Murtaz	מורטאז
Calouste	קאלוסט
Olmert	אולמרט
Fridtjof	פרידג'וף
Shilton	שילטון
Boutlilisse	בוטליליס
Rizk	ריזק
Moller	מולר
Josephs	ג'וסיפז
Flemming	פלימינג
Magen	מגן
Ryoma	ריומא
Nikolayev	ניקולאייב
Page	פייג'
Hariri	חרירי
Hickman	היקמאן
Kostas	קוסטאס
Kenya	קיניא
Utah	יוטה
Hermon	הרמון
Ostrava	אוסטראבא
Babylon	באבילון
Sufyan	סופיאן
Modou	מודו
Herman	הרמאן
Malakian	מלקיאן
Staten	סטאטן
Gennadi	גינאדי
Mt	מט
Cage	קייג'
Diesel	דיזל
Amuro	אמורו
Yari	יארי
Rykov	ריקוב
Prandelli	פראנדילי
Linderoth	לינדרות
Ponnet	פוניט
Zubeidi	זוביידי
Sari	סרי
Harith	חארית
Baibars	באיבארס
Pryor	פראיור
Hari	הארי
Shailene	שיילין
Dzhokhar	ג'וחר
Mari	מארי
Meissen	מיסן
Bilic	ביליטש
Frodo	פרודו
Erie	אירי
Costinha	קוסטינהא
Curro	קורו
Mzali	מזאלי
Krasnodar	קראסנודאר
Pattison	פאטיסון
Hemingway	המינגווי
Voltaire	וולטייר
Hideki	הידיקי
Collovati	קולוואטי
Keiser	קיסר
Sakimoto	סאקימוטו
Krug	קרוג
Fahrudin	פאהרודן
Astaire	אסטייר
Craddock	קראדוק
Shikabala	שיקאבאלא
Fighting	פאיטינג
Matisse	מאטיס
Haberkorn	האברקורן
Yamba	יאמבא
Camus	קאמו
Pato	פאטו
Wenger	וינגר
Ryusei	ריוסיי
Peltier	פלטייר
Absalom	אבסאלום
Cyprus	סאיפרוס
Toyota	טויוטא
Leipzig	לאיפזיג
Solomin	סולומין
Msarri	מסארי
Mitsubishi	מיטסובישי
Brandts	בראנץ
Gercaliu	גירקאליו
Leonid	ליוניד
Nakahara	נאקאהארא
Ludo	לודו
Stowe	סטו
Mariah	מאריא
Cleber	קליבר
Huntington	האנטנגטון
Murcutt	מורקוט
Mursal	מורסאל
Sheen	שין
Edgar	אדגאר
Duran	דוראן
Bangka	באנגקא
Cody	קודי
Hilton	הילטון
Arkhangelsk	ארכאנגילסק
Arthur	ארתור
Nayef	נאיף
Bartolomeu	בארתולומיו
Azar	אזאר
Trondheim	טרונדהאים
Shinto	שינטו
Carmagnola	קארמאנולא
Homnabad	הומנבאד
Filip	פיליפ
Hannibal	האניבאל
Mehlis	מיליס
Bayezid	באיזיד
Shinzo	שינזו
Fukunishi	פוקונישי
Seksan	סאקסאן
Wilton	וילטון
Tomislav	טומסלאב
Clarence	קלארנס
Sidqi	סידקי
Wellens	וילנס
Haas	האס
Sinibaldi	סיניבאלדי
Wallace	ואלאס
Parmenides	פארמנידס
Luhansk	לוהאנסק
Tugay	טוגאי
Kocsis	קושיס
Shinkichi	שינקיצ'י
Athanasius	אתנאסיוס
Allen	אלן
Bashar	בשאר
Hayflick	הייפליק
Salford	סאלפורד
Bashir	בשיר
Kasdi	קאסדי
Horatio	הוריישיו
Avigdor	אביגדור
Michelet	מישליט
Ghanem	גאנם
Laporta	לאפורטא
Emo	אימו
Hus	הוס
Horacio	הוראסיו
Eldad	אלדד
Baramidze	באראמידזה
Samtredia	סאמטרידיא
Rob	רוב
Munk	מנק
Milton	מילטון
Gus	גאס
Lamu	לאמו
Horst	הורסט
Enzo	אנזו
Goodison	גודיסון
Stepney	סטיפניי
Fortuno	פורטונו
Kayrouz	קיירוז
Friedman	פרידמאן
Krystian	קריסטיאן
Madame	מדאם
Nermin	נרמין
Agab	עגב
Catalina	קאטאלינא
Raimi	ראימי
Benni	בני
Fadlan	פדלאן
Costica	קוסטיקא
Minami	מינאמי
Vujanovic	בויאנוביטש
Pinter	פינטר
Nyarko	ניארקו
Theodoros	תיודורוס
Nurenberg	נורינבירג
Joleon	ג'וליון
Janssen	ג'אנסן
Yasunori	יאסנורי
Almanfaluti	אלמנפלוטי
Grassi	גראסי
Yemin	ימין
Sugita	סוגיטא
Constant	קונסטאנט
Homaidan	חומידאן
Annunziata	אנונסיאטא
Sassoon	סאסון
Halford	האלפורד
Johns	ג'ונז
Zambo	זאמבו
Smithies	סמיתיז
Kusturica	קוסטוריצא
Margaret	מארגריט
Mississippi	מיסיסיפי
Bodmer	בודמר
Venice	וניס
Hammoud	חמוד
Fernando	פרנאנדו
Ellen	אלן
Yaokun	יאוקון
Dolce	דולצ'ה
Ziyi	זיי
Carola	קארולא
Lewis	לויס
Melchior	מלקיור
Ludovic	לודוביק
Buchner	בוכנר
Thwaite	תואיט
Koharu	קוהארו
Priscus	פריסקוס
Paradorn	פאראדורן
Nicole	ניקול
Yangon	יאנגון
Leandro	ליאנדרו
Youssef	יוסף
Maldini	מאלדיני
Zan	זאן
Deodoro	דאודורו
Christensen	קריסטנסן
Masinga	מאסינגא
Bermuda	ברמודא
Hiroyuki	הירויוקי
Stievenard	סטיבינארד
Zambelli	זאמבילי
Ratomir	ראטומיר
Ian	איאן
Jan	יאן
Garfield	גארפילד
Azali	אזאלי
Contra	קונטרא
Arae	אראי
Oliveira	אוליביירא
Berman	ברמאן
Karlovy	קארלובי
Loos	לוס
Iordanescu	יורדאניסקו
Djawadi	ג'אואדי
Kostic	קוסטיטש
Lloyd	לויד
Maxime	מאקסים
Massey	מאסי
Zurab	זוראב
Hartree	הארטרי
Sanhedrin	סנהדרין
Djibril	ג'יבריל
Moumouni	מומוני
Bagdadi	בגדאדי
Guzzanti	גוצאנטי
Hisato	היסאטו
Hastings	הייסטינגס
Quentin	קוינטין
Sada	סאדא
Wang	ואנג
Tautou	טאטו
Cohen	כהן
Dekel	דקל
Tokyo	טוקיו
Cato	קייטו
Amal	אמל
Lieberman	ליברמאן
Nada	נאדא
Feras	פראס
Mcmanaman	מאקמאנאמאן
Kinski	קינסקי
Nilton	נילטון
Dada	דאדא
Hugo	היוגו
Rafi	רפי
Lugo	לוגו
Mcneill	מקניל
Pot	פוט
Kafi	קאפי
Channing	צ'אנינג
Nafi	נאפי
Rustavi	רוסטאבי
Octavio	אוקטאביו
Langton	לאנגטון
Hadzibegic	האדזיביגיטש
Vonlanthen	וונלאנתן
Valery	וואלרי
Brodsky	ברודסקי
Bambang	באמבאנג
Stokes	סטוקס
Aljaber	אלג'אבר
Chazz	שאז
Dziri	דזירי
Landreau	לאנדרו
Cudicini	קודיצ'יני
Cartagena	קארטאגינא
Epstein	אפסטין
Rothman	רותמאן
German	ג'רמאן
Luca	לוקא
Derbent	דירבינט
Israel	איזריל
Denmark	דנמארק
Burrell	בוריל
Dalmat	דאלמאט
Ramires	ראמירס
Terme	טירמי
Gein	גין
Chidiac	שידיאק
Barthez	בארטיז
Rossana	רוזאנא
Jozsef	ג'וזיף
Humpty	האמפטי
Celtic	סלטיק
Eugene	יוג'ין
Maciej	מאסיג'
Tchomogo	טשומוגו
Paramo	פאראמו
Hudna	הודנה
Teotihuacan	טיוטיהואקאן
Stockholm	סטוקהולם
Hirano	היראנו
Mascherano	מאסקיראנו
Charlotte	שארלוט
Hoshyar	הושיאר
Statham	סטאתאם
Panadol	פאנאדול
Gursel	גורסל
Hoffmann	הופמאן
Dahlman	דאלמאן
Zanetic	זאנטיק
Oryol	אוריול
Timbuktu	טימבקטו
Alicia	אליסיא
Schmeichel	שמאיקל
Nina	נינא
Poe	פו
Kahlo	קאהלו
Kosugi	קוסוגי
Iofan	איופאן
Natasha	נאטאשא
Joe	ג'ו
Donato	דונאטו
Prieto	פרייטו
Noe	נוי
Winter	וינטר
Luzzatto	לוזאטו
Ghazi	גאזי
Coe	קו
Shoshana	שושנה
Soweto	סויטו
Centauri	סנטורי
Poznan	פוזנאן
Laville	לאביל
Sheffield	שיפילד
Vicini	ויצ'יני
Jerome	ג'רום
Potsdam	פוטסדאם
Lepine	ליפאין
Tomas	טומאס
Jenei	ג'יניי
Gokdeniz	גוקדניז
Yoshito	יושיטו
Jumblatt	ג'ונבלאט
Maccabi	מכבי
Deanna	דיאנא
Nedved	נדביד
Lothar	לותאר
Salbutamol	סאלבוטאמול
Vejic	ויג'יטש
Miller	מילר
Kyu	קיו
Amir	עאמיר
Florentino	פלורנטינו
Golestan	גולסטאן
Sergey	סירגיי
Shafik	שפיק
Kadima	קדימה
Sweid	סויד
Glau	גלאו
Smush	סמאש
Schwimmer	שוימר
Magnificat	מאניפיקאט
Stratford	סטראטפורד
Moritz	מוריץ
Govou	גובו
Smashnova	סמאשנובא
Matsukata	מאטסוקאטא
Tiberius	טאיביריאס
Takagaki	טאקאגאקי
Liza	ליזא
Trochowski	טרוקווסקי
Jesper	יספר
Bouma	בומא
Salandra	סאלאנדרא
Giza	גיזה
Colleen	קולין
Nahla	נחלה
Paganini	פאגאניני
Haykel	האיקל
Danijel	דאנייל
Anno	אנו
Tram	טראם
Farrokhzad	פרוכזאד
Adwan	עדואן
Flamini	פלאמיני
Thor	תור
Jovan	ג'ובאן
Bram	בראם
Guimard	גימאר
Ray	ריי
Yasin	יאסין
Kokichi	קוקיצ'י
Tarak	טאראק
Hay	היי
Diourbel	דיורביל
Moawad	מועואד
Celestine	סילסטין
Trapattoni	טראפאטוני
May	מיי
Stephen	סטיפן
Ploetz	פלוטז
Day	דיי
Gaspard	גאספאר
Jehad	ג'האד
Palacio	פאלאסיו
Born	בורן
Yossef	יוסף
Gordian	גורדיאן
Konno	קונו
Elliot	אליוט
Winothai	וינותאי
Demme	דים
Giosue	ג'וסו
Nobre	נוברי
Pygmalion	פיגמאליון
Yamoussoukro	יאמוסוקרו
Taga	טאגא
Iskra	איסקרא
Doppler	דופלר
Garibaldi	גאריבאלדי
Miliband	מיליבאנד
Amram	עמרם
Gerhard	גרהארד
Unix	יוניקס
Hispaniola	היספאניולא
Carvalho	קאראבאלהו
Gaga	גאגא
T	ט
Humboldt	האמבולט
Barr	בר
Moscoso	מוסקוסו
Toffler	טופלר
Manninger	מאנינגר
Donatello	דונאטילו
Nauseb	נאוסב
Beidas	ביידאס
Dudamel	דודאמיל
Fyodor	פיודור
Low	לו
Schwarzenegger	שוארצניגר
Mesrob	מסרוב
Pete	פיט
Katerina	קאטרינא
Georgy	ג'ורג'י
Kelley	קילי
Drucker	דרוקר
Kapoor	קאפור
Eagleton	איגלטון
Pfeiffer	פפאיפר
Raffi	רפי
Liguria	ליגוריא
Mullery	מולרי
Hachilensa	האצ'ילינסא
Floyd	פלויד
Tina	טינא
Kaj	קאי
Karlovic	קארלוביטש
Morphy	מורפי
Pezzey	פיזיי
Murat	מוראט
Abhur	אבחור
Benes	בנס
Fuchs	פוקס
Sorbonne	סורבון
Shan	שאן
Pulitzer	פוליצר
Socrates	סוקראטס
Hazboun	חזבון
Magath	מאגאת
Khan	חאן
Murad	מוראד
Chan	צ'אן
Musonda	מוסונדא
Abercrombie	אברקרומבי
Gandhi	גאנדי
Burgmeier	ברגמאיר
Montasser	מונתסר
Zinn	זין
Category	קטגורי
Celentano	צ'לנטאנו
Sifi	סיפי
Woods	וודז
Maqluba	מקלובה
Rui	רוי
Nero	נירו
Kris	קריס
Majus	מג'וס
Drummond	דרומונד
Hindley	הינדלי
Motahhari	מוטהרי
Cris	קריס
Lendvai	לינדבאי
Ronald	רונאלד
Gris	גריס
Pocatello	פוקאטילו
Jabotinsky	ג'בוטנסקי
Hayden	האידן
Nazli	נאזלי
Queiroz	קירוז
Kobun	קובון
Zerka	זרקא
Anne	ען
Romario	רומאריו
Walzer	ואלצר
Sydney	סידני
Haymanot	האימאנוט
Shishelov	שישילוב
Ulises	אוליסס
Heiko	הייקו
Dossena	דוסינא
Colombo	קולומבו
Pau	פאו
Octavian	אוקטאביאן
Kristof	קריסטוף
Adygea	אדיגיא
Hertford	הירטפורד
Gilboa	גלבוע
Buyten	בויטן
Lindelof	לינדלוף
Behan	ביהאן
Kubo	קובו
Mekan	מקאן
Gediminas	גידימינאס
Dr.	דקטור
Xenophanes	קסינופאניס
Kanpur	קאנפור
Caviezel	קאביזל
Domagk	דומאק
Nambu	נאמבו
Yksel	יקסיל
Pompeo	פומפיו
Winslow	וינסלו
Wilshere	וילשיר
Sebastien	סיבאסטיאן
Ayil	עאיל
Davide	דביד
Mimoun	מימון
Jouhaux	ג'והו
Capri	קאפרי
Tymoschuk	טימושוק
Forsyth	פורסאית
Ramage	ראמאג'
Nebahat	נבאהט
Servet	סרוויט
Jomo	ג'ומו
Ashdod	אשדוד
Lorenzo	לורינזו
Lionel	לאיונל
Karam	קאראם
Kahramanmaras	קהרמאנמאראס
Elektra	אלקטרא
Simbi	סימבי
Kuroda	קורודא
Axum	אקסום
Lindsey	לינדסיי
Howe	האו
Wheater	ויטיר
Amundsen	אמונדסן
Adelaide	אדיליاד
Jurota	ג'ורוטא
Fadiga	פאדיגא
Salekhard	סאלכארד
Duke	דוק
Benson	בנסון
Justine	ג'אסטין
Salva	סאלבא
Walle	וולי
Cubillas	קובילאס
Caterina	קאטירינא
Gehan	גיהאן
Woolley	וולי
Talley	טאלי
Armia	ארמיא
Mesut	מיסוט
Shouaa	שועאע
Fermi	פירמי
Danner	דאנר
Valli	ואלי
Benjani	בנג'אני
Aoun	עאון
Leon	ליון
Kakheti	קאכיטי
Farhi	פרחי
Czeizler	קיזלר
Servetus	סירביטוס
Waldo	ואלדו
Kankoune	קנקוני
Nickelback	ניקילבק
Dermot	דירמוט
Bambi	באמבי
Wolmar	וולמאר
Senac	סינאק
Baykal	באיקאל
Metwalli	מטוואלי
Sfar	ספאר
Kilpin	קילפן
Princess	פרינסס
Linvoy	לינבוי
Rosenberg	רוזנברג
Rina	רינא
Alla	עלא
Mlađan	מלאדיאן
Seferis	ספריס
Patrice	פאטריס
Mina	מינא
Schiavone	שיאבוני
Leumi	לאומי
Brzic	ברזיטש
Dina	דינא
Rosh	רוש
Azilal	אזילאל
Fahrni	פארני
Syagrius	סיאגריוס
Kubrick	קובריק
Gaskell	גאסקל
Hrubesch	הרובש
Renan	רינאן
Aden	עדן
Cienfuegos	סיאנפויגוס
Smoot	סמוט
Schopenhauer	שופנהאור
Eden	עדן
Tereza	טיריזא
Schober	שוביר
Feliciano	פיליסיאנו
Vlada	וולאדא
Gosh	גוש
Miyu	מיו
Italy	איטאלי
Qaraoun	קרעון
Baysse	באיס
Sam	סאם
Voronin	בורונין
Tartu	טארטו
Ham	חאם
Kassai	קאסאי
Jesus	חיסוס
Camara	קאמארא
Hanbal	חנבל
Ferdoos	פרדוס
Meshulam	משולם
Dam	דאם
Rijsbergen	ריסבירגן
Kufuor	קופור
Macarthur	מאקארתר
Diogo	דיוגו
Barmos	בארמוס
Sebastian	סיבאסטיאן
Grimonpon	גרימונפון
Serena	סירינא
Cardozo	קארדוזו
Henan	הינאן
Arraba	אראבא
Cambiasso	קאמביאסו
Evariste	איבריסט
Rotana	רוטאנא
Scarlett	סקארליט
Yul	יול
Coste	קוסט
Nasra	נסרה
Brian	בריאן
Sul	סול
Borsellino	בורסילינו
Am	אם
Zokora	זוקורא
Rabiu	ראביו
Ryan	ראיאן
Kul	קול
Curzon	קורזון
Yfrah	יפראח
Materazzi	מאטיראצי
Ganjavi	גאנג'אוי
Gibbon	גיבון
Ful	פול
Gul	גול
Sonko	סונקו
Chimbonda	צ'ימבונדא
Zairi	זאירי
Fredric	פרידריק
Miyamoto	מיאמוטו
Demis	דימיס
Rabin	רבין
Bruce	ברוס
Pagels	פייגלז
Heaton	היטון
Steyr	סטייר
Tahmasp	טהמאספ
Prost	פרוסט
Shoukry	שוקרי
Kuraki	קוראקי
Weil	וייל
Tito	טיטו
Buzek	בוזק
Mauriac	מוריאק
Jito	ג'יטו
Segev	סגב
Belhadj	בלחאג'
Sabatini	סאבאטיני
Amor	עמור
Trieste	טריסט
Takfiri	טקפיריה
Salamanca	סאלאמאנקא
Blitzer	בליצר
Tomoyuki	טומויוקי
Nehoda	ניהודא
Halliwell	האליוול
Desi	דסי
Shishakli	שישאקלי
Tschumi	צ'ומי
Trivic	טריביטש
Hossein	חוסין
Ferlito	פרליטו
Libertadores	ליברטאדוריס
Lumumba	לומומבא
Witold	ויטולד
Giora	גיורא
Reitsch	ראיטש
Marcuse	מארקוז
Donald	דונאלד
Alisfahani	אלאיספהאני
Khairat	חאיראט
Bachmann	באכמאן
Eskell	אסקיל
Poll	פול
Faison	פייזון
Atwood	אטווד
Livathinos	ליבאתינוס
Holl	הול
Michihiro	מיצ'יהירו
Midorikawa	מידוריקאוא
Kelso	קילסו
Bree	ברי
Trail	טרייל
Rowling	רולינג
Merton	מירטון
Basinger	באסינגר
Ando	אנדו
Kiri	קירי
Gudelj	גודילי
Kenan	קינאן
Tilda	טילדא
Christoph	קריסטוף
Duscher	דושיר
Bohlen	בולן
Melki	מלקי
Balint	באלינט
Galois	גאלוא
Claudio	קלאודיו
Sayed	סייד
Colak	קולאק
Juuso	יוסו
Raul	ראול
Kempes	קימפס
Kaloyev	קאלוייב
Ransome	ראנסום
Jenas	ג'ינאס
Nimba	נימבא
Katakana	קאטאקאנא
John	ג'ון
Puchner	פוכנר
Saif	סאיף
Riveros	ריבירוס
Mikimoto	מיקימוטו
Hummelt	הומילט
Esperanto	אספראנטו
Gekas	גיקאס
Cohn	קון
Tver	טביר
Hegel	היגל
Naif	נאיף
Lavra	לאברא
Nikolaos	ניקולאוס
Pistoia	פיסטויא
Kashmir	קשמיר
Bedi	בדי
Masaaki	מאסאקי
Hintermaier	הינטרמאיר
Piet	פיט
Bethesda	ביתיסדא
Marta	מארטא
Halutz	חלוץ
Alahram	אלאהראם
Simferopol	סימפירופול
Robben	רובן
Dominic	דומיניק
Ramazan	רמזאן
Alfarazdaq	אלפרזדק
Colmar	קולמאר
Ferydoon	פריידון
Galeazzo	גאליאצו
Drew	דרו
Pietro	פייטרו
Robbie	רובי
Figaro	פיגארו
Europa	יורופא
Sampi	סאמפי
Karimi	קרימי
Borgetti	בורגיטי
Jorgensen	יורגנסן
Balde	באלדי
Wilkie	וילקי
Dimba	דימבא
Arbel	ארביל
Germanium	גירמאניום
Siddig	סידיג
Delfino	דלפינו
Siyabonga	סייאבונגא
Ruiz	רויז
Slavisa	סלאביסא
Carnegie	קארנגי
Rivilla	ריבילא
Polgar	פולגאר
Paraguay	פאראגואי
Delimkhanov	דלימכאנוב
Gemmei	גימיי
Silva	סילבא
Ruutel	רוטל
Bozanic	בוזאניטש
Laslandes	לאסלאנד
Gallois	גאלוא
Corrie	קורי
Hilde	הילדי
Aston	אסטון
Cunningham	קונינגהאם
Sarukhan	סארוכאן
Montparnasse	מונפארנאס
Srpska	סרפסקא
Tallinn	טאלין
Attica	אטיקא
Tashiro	טאשירו
Urey	יורי
Vaduz	ואדוז
Biella	ביילא
Tagore	טאגור
Wilde	ואילד
Bouchaib	בושעיב
Ryoichi	ריוצ'י
Gallo	גאלו
Suchoparek	סוצ'ופאריק
Velimir	ולימיר
Grey	גריי
Xerces	זירסיז
Mujic	מוג'יטש
Davydenko	דאווידינקו
Dias	דיאס
United	יונאיטד
Tuo	טו
Gonnohyoe	גונוהיו
Michelangelo	מאיקלאנג'ילו
Jennifer	ג'ניפר
Baloncieri	באלונשיירי
Bangoura	באנגורא
Maimon	מאימון
Eros	אירוס
Prometheus	פרומיתיוס
Klibi	קליבי
Aikido	איקידו
Joschka	יושקא
Gallardo	גאלארדו
Bianca	ביאנקא
Ashraf	אשרף
Janssens	יאנסינס
Mazarin	מאזארין
Shakira	שאקירא
Tammuz	תמוז
Silkwood	סילקווד
Cleanth	קלינת
Fogh	פוג
Gogh	גוג
Zino	זינו
Olivero	אוליבירו
Lipoma	ליפומא
Tukar	טוקאר
Masilela	מאסילילא
Lordan	לורדאן
Zevi	צבי
Boutahar	בוטהאר
Lucille	לוסיל
Pierangelo	פייראנגלו
Nabih	נאבי
Last	לאסט
Rodrigues	רודריגז
Tsepo	ציפו
Mariupol	מאריופול
Levi	ליואי
Brenner	ברנר
Eliyahu	אליהו
Rodriguez	רודריגיז
Bridge	ברידג'
Fenelon	פנלון
Lindfield	לינדפילד
Brocic	ברושיטש
Taut	טאוט
Copenhagen	קופנהאגן
Koizumi	קויזומי
Ealing	אילינג
Dominique	דומיניק
Sullivan	סאליבן
Numidia	נומידיא
Conceicao	קונסיסאו
Dacourt	דאקורט
Abkhazia	אבחאזיא
Yassine	יאסין
Rool	רול
Vyshnevskyi	וישנבסקי
Netafim	נטפים
Shaw	שו
Wexler	וקסלר
Bazzani	באזאני
Kurdistan	קורדיסטאן
Bernays	ברנייז
Hurt	הורט
Theodora	תיודורא
Artem	ארטים
Karlsson	קארלסון
Cuneo	קוניו
Bandaranaike	באנדאראנאיקה
Colbert	קולברט
Stanishev	סטאנישב
Kakhi	קקי
Burt	בורט
Weaving	ויבינג
Tahiti	טאהיטי
Milva	מילבא
Tarlev	טארליב
Kakha	קאכא
Thomas	טומאס
Scherbius	שירביוס
Katayama	קאטאיאמא
Lipmann	ליפמאן
Koloman	קולומאן
Ikebana	איקיבאנא
Fukuda	פוקודא
Michel	מישל
Kristin	קריסטין
Zhekov	ז'קוב
Michal	מיקאל
Apulia	אפוליא
Lahzami	לחזאמי
Shlomo	שלמה
Renquin	רינקוין
Fazio	פאזיו
Vingada	וינגאדא
Ralf	ראלף
Ernie	ארני
Laird	לירד
Barack	ברק
Katsuki	קאטסוקי
Kay	קיי
Michelle	מישל
Mutarelli	מוטארילי
Helder	הילדר
Dolmans	דולמאנז
Diego	דייגו
Nordin	נורדין
Nattaporn	נאטאפורן
Bay	ביי
Lars	לארס
Elmaleh	אלמאלח
Apophis	אפופיס
Maranhao	מאראנהאו
Mann	מן
Conchita	קונשיטא
Jorvan	ג'ורבאן
Pochettino	פוטשיטינו
Santana	סאנטאנא
Bardsley	בארדסלי
Macias	מאסיאס
Kingson	קינגסון
Sebastiao	סבאסטיאו
Gann	גאן
Proxima	פרוקסימא
Dahan	דהאן
Mottaki	מוטאקי
Dichter	דיכטר
Daham	דהאם
Buriani	בוריאני
Rimbaud	רימבו
Srichaphan	סראישאפאן
Wirth	ורת
Mehmed	מחמד
Tonton	טונטון
Brodie	ברודי
Bragg	בראג
Braga	בראגא
Cervantes	סרבאנטס
Yakushima	יאקושימא
Barison	באריסון
Yosef	יוסף
Kees	קיז
Zac	זאק
Fifi	פיפי
Wisnieski	ויסניסקי
Quinton	קוינטון
Innsbruck	אינסברוק
Shomu	שומו
Kuranyi	קוראני
Nurmi	נורמי
Tumer	טומר
Colombia	קולומביא
Mac	מאק
Calderon	קאלדירון
Mpenza	מפינזא
Guillaume	גויאם
Adriatic	אדריאטיק
Mirnyi	מירני
Heinze	האינז
Green	גרין
Bromley	ברומלי
Tchami	טשאמי
Sanchez	סאנשיז
Glycine	גליסין
Rose	רוז
Sanae	סאניי
Bru	ברו
Kandia	קאנדיא
Crocker	קרוקר
Shaul	שאול
Fichtner	פישטנר
Shaun	שון
Auhah	עוהה
Helsinki	הלסינקי
Seko	סיקו
Teko	טיקו
Hazazi	הזאזי
Old	אולד
Iskitim	איסקיטים
Bordon	בורדון
Rehema	רחימה
Bordin	בורדין
Miyazaki	מיאזאקי
Yard	יארד
Schami	שאמי
Scheveningen	שיבינינגן
Machaalani	משעלאני
Boiany	בויאני
Googoosh	גוגוש
Harvey	הארבי
Ward	וורד
Hard	הארד
Rohan	רוהאן
Smiljanic	סמיליאניטש
Shawqat	שוקט
Almeyda	אלמידא
Elyashiv	אלישיב
Huub	הוב
Gard	גארד
Mcstay	מקסטיי
Viale	ויאלי
Trnava	טרנאבא
Swaggart	סואגארט
Sadler	סאדלר
Koevermans	קוברמאנס
Melanesia	מילאניזיא
Tedd	טיד
Karaganda	קאראגאנדא
Mostovoi	מוסטובוי
Zahi	זאהי
Campo	קאמפו
Queeny	קויני
Wuthrich	ווטריך
Vicente	ויסנטה
Farahani	פראהאני
Miletus	מיליטוס
Isser	איסר
Hanzo	האנזו
Mehrzad	מהרזאד
Cross	קרוס
Burton	בורטן
Bimkom	במקום
Garang	גאראנג
Danielsen	דאניילסן
Hiyama	היאמא
Muir	מויר
Schussel	שוסל
Ladislav	לאדיסלאב
Varallo	ואראיו
Mehrdad	מהרדאד
Clinton	קלינטון
Octane	אוקטאן
Poirot	פוירוט
Roemer	רומר
Ruiter	רויטר
Fish	פיש
Fahad	פהד
Yakushin	יאקושין
Zlatan	זלאטאן
Tuapse	טואפסי
Dwight	דואיט
Anghel	אנגיל
Gonzalez	גונזאלז
Baird	בירד
Berggreen	ברגרין
Pennant	פינאנט
Pfister	פפיסטר
Vaclav	ואצלאב
Hutchinson	הוטשינסון
Hadziabdic	האדזיאבדיטש
Percy	פירסי
Clyde	קלייד
Mngomeni	מנגומיני
Tudyk	טודיק
Morricone	מוריקוני
Thesiger	תיסיגר
Giagnoni	ג'אניוני
Prokop	פרוקופ
Barnard	ברנאר
Yazid	יזיד
Petter	פיטר
Khumalo	קומאלו
Nafti	נפטי
Boutros	בוטרוס
Molina	מולינא
Miyata	מיאטא
Fielding	פילדינג
Gael	גייל
Zapp	זאפ
Ferreira	פיריירא
Steffen	סטיפן
Lindsay	לינדסיי
Switzerland	סויצרלאנד
Sylvain	סילביין
Rapp	ראפי
Pinhas	פנחס
Sampras	סאמפראס
Lily	לילי
Rapoport	ראפופורט
Kjar	קיאר
Diderot	דידרו
Anubis	אנוביס
Lolita	לוליטא
Kadisha	קאדישא
Ayyash	עיאש
Amedeo	אמידיו
Manaf	מנאף
Takeshi	טאקישי
Finger	פינגר
Haan	האן
Rumsfeld	ראמספילד
Grimi	גרימי
Heyrovsky	הاירובסקי
Bennett	בנט
Naan	נאן
Little	ליטל
Behrami	בהראמי
Makonnen	מאקונין
Marx	מארקס
Karadeniz	קאראדינז
Chrysler	קראיסלר
Schuster	שוסטר
Emden	אמדן
Dalton	דאלטון
Salampessy	סאלאמפסי
Hemdan	חמדאן
Stoltenberg	סטולטנברג
Butler	באטלר
Tadiran	טאדיראן
Latvia	לאטביא
Peutinger	פויטינגר
Shiff	שיף
Kleff	קליף
Srinagar	סרינאגאר
Chevrolet	שיברוליי
Hawatmeh	חוואטמה
Frost	פרוסט
Vlasic	ולאסיטש
Zyad	זיאד
Siphandon	סיפאנדון
Christou	קריסטו
Ani	אני
Niall	ניאל
Brunei	ברוניי
Stendardo	סטינדארדו
Jandali	ג'נדלי
Sparta	ספארטא
Ashkenazi	אשכנזי
Zanetti	זאניטי
Kfoury	קפורי
Horna	הורנא
Jospin	ג'וספאן
Horne	הורן
Cumin	קיומין
Motoko	מוטוקו
Naomi	נעמי
Mohammed	מוחמד
Papin	פאפין
Leptin	ליפטין
Nazik	נאזיק
Kido	קידו
Kogyoku	קוגיוקו
Hiddink	הידינק
Couto	קוטו
Serbia	סרביא
Johar	ג'והר
Jaap	ג'אפ
Pontes	פונטיס
Chiba	צ'יבא
Wendee	ונדי
Wiertz	וירץ
Buinsk	בוינסק
Slovakia	סלובאקיא
Ostrovsky	אוסטרובסקי
Paramor	פאראמור
Evans	איבאנז
Sanger	סאנגר
Kolkata	קלקטא
Rothlisberger	רותליסבירגר
Pelli	פילי
Dixon	דיקסון
Europe	יורופ
Sibusiso	סיבוסיסו
Dagestan	דאגסטאן
Root	רוט
Andranik	אנדראניק
Shibata	שיבאטא
Lyon	ליון
Worthington	ורתינגטן
Qaruh	קארוה
Tokio	טוקיו
Mcqueen	מאקקוין
Ajax	איג'אקס
Grunbein	גרונביין
Muharram	מוחארם
Tikrit	טיקריט
Chemnitz	צ'מניץ
Kotoko	קוטוקו
Sandler	סאנדלר
Tonu	טונו
Iverson	איברסון
Heraclitus	היראקליטס
Peterson	פיטרסון
Trygve	טריגבי
Chace	צ'ייס
Hibbert	היברט
Mittal	מיטאל
Makinwa	מאקינוא
Cantona	קאנטונא
Teerathep	טיראתפ
Streller	סטרילר
Duhamel	דוהאמל
Blackstone	בלאקסטון
Rosenblatt	רוזנבלאט
Scheuring	שוירינג
Baudrillard	באודרילארד
Azd	אזד
Ismet	עיסמט
Intron	אינטרון
Kadyrov	קדירוב
Lorna	לורנא
Camille	קאמיל
Clarke	קלארק
Mihaly	מיהאלי
Kesselring	קיסלרינג
Domitian	דומיטיאן
Pioline	פיולין
Dawson	דוסן
Maderno	מאדירנו
Lagos	לאגוס
Puli	פולי
Janko	יאנקו
Dudek	דודק
Barusso	בארוסו
Leung	לונג
Fumio	פומיו
Thembinkosi	תימבנקוסי
Venezia	ויניזיא
Emerson	אמרסון
Hoskins	הוסקינס
Bozoljac	בוזולג'אק
Handler	האנדלר
Arafat	ערפאת
Adler	אדלר
Lynndie	לינדי
Rimon	רימון
Khodadad	חודאדאד
Lazzaro	לאזארו
Maximilien	מאקסמליאן
Mcbeal	מקביל
Apollo	אפולו
Lacarne	לאקארן
Haran	חאראן
Kling	קלינג
Tasso	טאסו
Shinrikyo	שינריקיו
Ivry	איברי
Muscat	מוסקאט
Chraibi	שראיבי
Sylva	סילבא
Alghifari	אלגיפארי
Ahmed	אחמד
Hojeij	חוג'ייג'
Bugzilla	בגזילא
Murty	מורטי
Petru	פיטרו
Reiziger	ראיזיגיר
Ratko	ראטקו
Honshu	הונשו
Woodcock	וודקוק
Francileudo	פראנסילודו
Castilla	קאסטילא
Guadeloupe	גואדלופ
Gilead	גיליאד
Artemis	ארטימיס
Petri	פיטרי
Fiala	פיאלא
Zhu	ז'ו
Zaur	זאור
Maguire	מאגואיר
Manning	מאנינג
Oued	וד
Boye	בוי
Sanader	סאנאדר
Chirac	שיראק
Chadili	שאדלי
Methane	מיתיין
Junghans	יונגהאנז
Hollis	הוליס
Jorn	יורן
Noriko	נוריקו
Radwanska	ראדואנסקא
Lockhart	לוקהארט
Sen	סן
Geology	גי'ולוג'י
Dunam	דונם
Veloso	ולוסו
Dunai	דונאי
Ken	קן
Paracetamol	פאראסיטאמול
Goethe	גתה
Ben	בן
Baartman	בארטמאן
Assem	עאסם
Roland	רולאנד
Rovinj	רובינג'
Voreadis	ווריאדיס
Emilio	אמיליו
Valkyrie	ואלקירי
Lambourde	לאמבורד
Bigogno	ביגוניו
Malisse	מאליסה
Woodrow	וודרו
Mbo	מבו
Melbourne	מלבורן
Glen	גלן
Trotta	טרוטא
Polly	פולי
Dorigo	דוריגו
Bergen	בירגין
Efrat	אפרת
Heitinga	היטינגא
Saivet	סאיביט
Pim	פים
Carrick	קאריק
Lavan	לבן
Gilbert	גילברט
Laval	לאבאל
Wim	וים
Tommot	טומוט
Weaver	ויבר
Peters	פיטרז
Linux	לינוקס
Moore	מור
Vangelis	ואנגיליס
Harun	הארון
Marco	מארקו
Razvan	ראזבאן
Nogly	נוגלי
Frida	פרידה
Seppi	סיפי
Toledo	טולידו
Leekens	ליקנז
Condoleezza	קונדוליזא
Isaac	איזאק
Carsley	קארסלי
Omri	עמרי
Swaziland	סואזילאנד
Huppert	הופירט
Potok	פוטוק
Bohdan	בודאן
Zitka	זיטקא
Mejdi	מג'די
Mariner	מארינר
Sojourner	סוג'ורנר
Haryana	האריאנא
Su	סו
Eretria	אריטריא
Julian	ג'וליאן
Barker	בארקר
Zeitoun	זיטון
Lucio	לוסיו
Bu	בו
Aldair	אלדייר
Shankar	שאנקאר
Clampett	קלאמפיט
Leonor	ליונור
Javad	ג'אוואד
Theofanis	תיופאניס
Florian	פלוריאן
Lucia	לוסיא
Essen	אסן
Glover	גלובר
Clint	קלינט
Wenhui	וינהוי
Bringas	ברינגאס
Bolton	בולטון
Mwanza	מואנזא
Kornberg	קורנברג
Chamberlain	צ'יימברלין
Sheridan	שירידאן
Mercator	מירקאטור
Walt	ואלט
Josef	ג'וסף
Kelly	קילי
Yaron	ירון
Mccallany	מקאלאני
Forrester	פורסטר
Luther	לותר
Zubizarreta	זוביזאריטא
Shalhoub	שלהוב
Pantelic	פאנטיליטש
Alina	אלינא
Lennon	לנון
Acasuso	אקאסוסו
Brest	בריסט
Lota	לוטא
Sundell	סאנדל
Bluitgen	בלוטגן
Chikao	צ'יקאו
Sturt	סטורט
Hsien	חסין
Virgil	וירגיל
Stroessner	סטרוסנר
Hartmann	הארטמאן
Shittu	שיטו
Madelung	מאדלונג
Adonis	אדוניס
Belmont	בלמונט
Minamoto	מינאמוטו
Minerva	מינרבא
Valletta	ואליטא
Given	גיבן
Kenyatta	קיניאטא
Talmud	תלמוד
Thabet	תאבט
York	יורק
Yannis	יאניס
Florianopolis	פלוריאנופוליס
Rollo	רולו
Nobel	נובל
Maziq	מאזיק
Bismarck	ביסמארק
Givet	גיביט
Kaddoumi	קדומי
Dresden	דרסדן
Diniyar	דינייאר
Gusenbauer	גוסנבאור
Hellebuyck	היליבויק
Hirsch	הירש
Mwaruwari	מוארווארי
Raef	ראאף
Shulamit	שולמית
Battista	באטיסטא
Milburn	מילבורן
Loic	לואק
Rivas	ריבאס
Hydrography	האיג'רוגראפי
Totma	טוטמא
Dramane	דראמאן
Yacob	יעקוב
Muntasser	מונתסר
Lazio	לאזיו
Holly	הולי
Issam	עסאם
Kariri	קרירי
Helman	הלמאן
Palau	פאלאו
Sessegnon	סיסגנון
Robinho	רובינהו
Fayol	פאיול
Valerio	ואליריו
Allyson	אליסון
Masaryk	מאזאריק
Berisha	בארישא
Lissitzky	ליסיצקי
Nelly	נלי
Kassir	קסיר
Muammar	מועמר
Lea	ליא
Richie	ריצ'י
Boissier	בויסייר
Bea	בי
Hawke	הוק
Wozniak	וזניאק
Majorca	מאיורקא
Madonna	מאדונא
Brin	ברין
Remy	רמי
Kirshner	קירשנר
Tajwid	תג'וויד
Kohn	קון
Miley	מאילי
Watros	ואטרוס
Sasaki	סאסאקי
Genghini	גינגיני
Sayyid	סאייד
Stefanson	סטפאנסון
Shaked	שקד
Agnon	עגנון
Tayma	טאימא
Della	דילא
Sarsur	סרסור
Bongartz	בונגארץ
Halevy	הלוי
Tange	טאנג'ה
Dis	די
Edie	אדי
Shipman	שיפמאן
Zakaria	זקריא
Ladd	לאד
Papafloratos	פאפאפלוראטוס
Yazalde	יאזאלדי
Reinaldo	רינאלדו
Masashi	מאסאשי
Ghannam	גנאם
Shimshon	שמשון
Malkhaz	מאלכאז
Wataru	ואטארו
Caniggia	קאניגיא
Karanusic	קראנוסיטש
Perl	פירל
Kristen	קריסטין
Aguilera	אגוילירא
Monty	מונטי
Khairy	חיירי
Guccione	גוצ'יון
Darui	דארוי
Montt	מונט
Heynemann	היינימאן
Canetti	קאניטי
Tampa	טאמפא
Berl	בירל
Bella	בילא
Abebe	אביבי
Newsted	ניוסטד
Monti	מונטי
Nassar	נסאר
Monte	מונטי
Ata	עטא
Felsner	פילסנר
Earhart	אירהארט
Nazif	נזיף
Maya	מאיא
Haber	האבר
Waldheim	ואלדהאים
Keitel	קאיטל
Beadle	בידל
Nazim	נאזים
Haqqi	חקי
Kushnir	קושניר
Nazis	נאציז
Saez	סאיז
Ljubomir	ליובומיר
Vinson	וינסון
Salas	סאלאס
Salar	סאלאר
Srur	סרור
Koruturk	קורוטורק
Degauque	דיגוק
Majeed	מג'יד
Ara	ערא
Dragnea	דראגניא
Bramante	בראמאנטי
Macdiarmid	מאקדירמיד
Thio	תיו
Salam	סלאם
Lewinsky	לוינסקי
Patton	פאטן
Furuya	פורויא
Salah	סלאח
Grossman	גרוסמאן
Litvinenko	ליטבינינקו
Sesto	ססטו
Ohio	אוהיו
Faltermeyer	פאלטרמאיר
Vasari	ואסארי
Aaronsohn	ארונסון
Casillas	קאסיאס
Michalis	מיקאליס
Salazar	סאלאזאר
Hellmut	הילמוט
Kasraoui	קסראוי
Dorsin	דורסן
Bull	בול
Ovadia	עובדיה
Sotiris	סוטיריס
Rameau	ראמו
Carini	קאריני
Plessers	פליסירז
Itamar	איתמר
Makelele	מאקיללי
Ramel	ראמל
Chepita	צ'פיטה
Bakr	בקר
Masaki	מאסאקי
Rizik	ריזיק
Bhamdoun	בחמדון
Markku	מארקו
Renato	רינאטו
Zaytsev	זאיטסיב
Buryatia	בוריאטיא
Perkins	פירקינז
Romanians	רומייניאנז
Ullman	אולמאן
Miyazawa	מיאזאוא
Gianni	גwאני
Lahoud	לחוד
Brahma	בראהמא
Yacef	יאסף
Howells	האוולז
Linney	ליני
Tamblyn	טאמבלין
Ballack	באלאק
Ballotta	באלוטא
Vanga	ואנגא
Menachem	מנחם
Soderling	סודרלינג
Judah	ג'ודה
Souk	סוק
Stefania	סטיפאניא
Bilbao	בילבאו
Giourkas	ג'ורקאס
Tadeus	טדיוס
Ndao	נדאו
Carrey	קארי
Vladic	ולאדיטש
Avshalom	אבשלום
Huckabee	האקאבי
Alistair	אליסטיר
Rouwaida	רואידא
Faruk	פארוק
Pagnani	פאניאני
Bridges	ברידג'ז
Gleeson	גליסון
Manga	מאנגה
Malcolm	מאלקולם
Ebadi	עבאדי
Wanis	ואניס
Saumel	סאומיל
Sabbah	סבאח
Caillebotte	קאייבוט
Fredriksson	פרידריקסון
Cordell	קורדל
Blokhin	בלוכין
Jacquet	ג'אקה
Pearce	פירס
Sinn	סין
Jonbent	ג'ונבינט
Kariokka	קאריוקא
Winn	וין
Halevi	הלוי
Mitropoulos	מיטרופולוס
Ted	טד
Lange	לאנג
Slavonia	סלאווניא
Lavronenko	לאברונינקו
Jaber	ג'אבר
Kiselyov	קיסיליוב
Neville	נוויל
Fakhri	פכרי
Fischler	פישלר
Coventry	קובנטרי
Jock	ג'וק
Rabbah	ראבא
Lyonne	ליון
Hubais	הובייס
Josu	חוסו
Asier	אסייר
Nishikori	נישיקורי
Willis	ויליס
Warnock	וארנוק
Gusarov	גוסארוב
Brendell	ברינדל
Kinsey	קינזי
Almenbar	אלמנבר
Malal	מלאל
Leilei	לייליי
Hatem	חאטם
Yadin	ידין
Saeed	סעיד
Carragher	קאראגר
Meriem	מרים
Mamet	מאמט
Perlman	פרלמאן
Vieira	ויירא
Gideon	גידיון
Karolina	קארולאינא
Kalililo	חלילילו
Naftali	נפתלי
Khalid	חאלד
Formosa	פורמוזא
Walsh	ואלש
Valeri	ואלירי
Vic	ויק
Drovetti	דרוויטי
Adam	אדם
Fraser	פרייזר
Redondo	רידונדו
Juhasz	ג'והאז
Conti	קונטי
Keizo	קייזו
Ayala	איילה
Harlan	הארלאן
Dushanbe	דושאנבה
Carteron	קארטירון
Snir	סניר
Minnesota	מיניסוטא
Kampf	קאמפף
Tzu	טזו
Kalam	קלאם
Gladstone	גלאדסטון
Nivola	ניבולא
Steven	סטיבן
Tibet	טיבט
Rexhepi	רקפי
Musampa	מוסאמפא
Kalaf	קאלאף
Heenan	הינאן
Kalac	קאלאטש
Imola	אימולא
Dicaprio	דיקפריו
Augusto	אוגוסטו
Venkov	ונקוב
Clancy	קלאנסי
Ugyen	יוגיין
Dietrich	דיטריך
Pennac	פנאק
Holderlin	הולדרלין
Kafr	קאפר
Wentworth	ונטוורת
Assad	אסד
Komodo	קומודו
Kishimoto	קישימוטו
Gazprom	גאזפרום
Rogerio	רוגיריו
Basma	בסמה
Barragan	בראגאן
Knut	קנוט
Mississauga	מיסיסוגא
Shamma	שמה
Janis	ג'אניס
Jamel	ג'אמל
Munitis	מונאיטיס
Zeroual	זרואל
Cohade	קוהייד
Simpsons	סימפסונז
Tumart	טומארט
Batatu	בטאטו
Kohler	קולר
Zuabi	זועבי
Schumann	שומאן
Aono	אונו
Bono	בונו
Mahut	מאהוט
Madeira	מאדירא
Marlon	מארלון
Isam	עיסאם
Munzinger	מונזינגר
Haehnel	האהניל
Rushdy	רושדי
Minnie	מיני
Magellan	מאגלאן
Joyce	ג'ויס
Berlusconi	ברלסקוני
Sesumaga	סיסומאגא
Gibbs	גיבז
Tyumen	טיומין
Prussia	פראשא
Chuikov	צ'ויקוב
Fauci	פוסי
Lenny	לני
Maron	מארון
Cabel	קאבל
Shmona	שמונה
Brook	ברוק
Khrushchev	חרושצ'ב
Kateb	קאטב
Maroc	מארוק
Sderot	שדרות
Singh	סינג
Ayouch	עיוש
Mikael	מיקאיל
Vesey	ויסי
Nesta	נסטא
Velha	ולהא
Daneshvar	דאנשוור
Lambrichts	לאמבריכטס
Vliegen	וליגן
Kenny	קיני
Kiyomori	קיומורי
Sawiris	סאויריס
Uthman	עותמאן
Shinawatra	שינאואטרא
Sidney	סידני
Mahyadi	מאהיאדי
Venglos	וונגלוס
Hattori	האטורי
Indurain	אינדוריין
Melho	מלחו
Ingmar	אינגמאר
Khalilou	חלילו
Jansson	ג'אנסון
Carlsen	קארלסן
Guillermo	גוילירמו
Emmy	אמי
Bristol	בריסטול
Esna	אסנא
Zimmerman	זימרמאן
Tarif	טריף
Karol	קארול
Khizanishvili	קיזאנישבילי
Salhab	סלהב
Irad	איראד
Taliban	טאליבאן
Asia	איז'א
Jenni	ג'ני
Memering	מימירנג
Arad	אראד
Brad	בראד
Kazakhstan	קאזאכסטאן
Dalal	דלאל
Valentino	ואלנטינו
Yahav	יאהאב
Teugels	טיגילס
Khater	חאטר
Valentine	ואלנטין
Brockie	ברוקי
Mekorot	מקורות
Corsetti	קורסיטי
More	מור
Dania	דאניא
Lapid	לפיד
Tzvetan	צביטאן
Poitier	פואטייה
Helpman	הילפמאן
Mosa	מוסא
Alexei	אליקסיי
Sawashiro	סאואשירו
Cosa	קוסא
Junko	ג'אנקו
Perlmutter	פירלמוטר
Straw	סטרו
Oskarsdottir	אוסקארסדוטיר
Kliment	קלימנט
Mamo	מאמו
Ramzan	רמזאן
Timberlake	טימברלייק
Zafour	זאפור
Lukasz	לוקאס
Meg	מיג
Benazir	בנאזיר
Canio	קאניו
Katlego	קאטליגו
Sperl	ספארל
Zvi	זבי
Gaber	גאבר
Aron	ארון
Fayyad	פאיאד
Suleyman	סוליימאן
Domingo	דומינגו
Finney	פיני
Bertolt	ברטולט
Cromwell	קרומוול
Isis	אייסיס
Sidorenko	סאידורניקו
Nahum	נחום
Paradiso	פאראדיסו
Sulejman	סוליימאן
Ebla	אבלא
Kerzhakov	קירזהאקוב
Bandler	באנדלר
Lilienthal	לילינטאל
Pasqualetti	פאסקואליטי
Maaya	מאיא
Hashemian	האשמיאן
Mayumi	מאיומי
Perrineau	פירינו
Bnei	בני
Tarcisio	טארשיזיו
Pollak	פולק
Deimos	דיימוס
Hurwitz	הורויץ
Natalia	נאטאליא
Fahmi	פהמי
Kist	קיסט
List	ליסט
Faso	פאסו
Neves	ניביס
Elghitani	אלגיטאני
Wazzan	ואזאן
Konstantin	קונסטאנטין
Calgary	קאלגארי
Fahmy	פהמי
Morgner	מורגנר
Couperin	קופירין
Pasanski	פאסאנסקי
Bismillah	ביסמילה
Riskin	ריסקין
Rateb	ראטב
Nagma	נאגמא
Rowen	רוון
Galal	גלאל
Schliemann	שלימאן
Ouertani	ורטאני
Daron	דארון
Darom	דארום
Kayumi	קאיומי
Yehud	יהוד
Sakamoto	סאקאמוטו
Mairead	מיריד
Lovelace	לובלייס
Bates	בייטס
Asatiani	אסאטיאני
Sertic	סירטיטש
Pero	פירו
Gottfried	גוטפריד
Sabau	סאבאו
Sabat	סאבאט
D	די
Tarantino	טאראנטינו
F	אף
Carle	קארל
Lous	לוס
Milad	מילאד
Pykalisto	פיקאלסטו
Marjane	מרג'אן
Catton	קאטון
Osama	אוסאמה
Joao	ג'ואו
Becher	בישר
Bruner	ברונר
Hadjaoui	חג'אוי
Ganis	גאניס
Burckhardt	בורקהארט
Mclean	מקלין
Sarraute	סארוט
Gutierrez	גוטייריז
Saban	סאבאן
Koichi	קויצ'י
Dory	דורי
Rondonia	רונדוניא
Tiago	טיאגו
Josephine	ג'וזפין
Cvetkovic	סביטקוביטש
Mccormick	מאקורמיק
Loboue	לובוי
Shariati	שריעטי
Gilles	גיל
Tosic	טוסיטש
Benny	בני
Darrell	דאריל
Daar	דאר
Maric	מאריק
Simonov	סימונוב
Galvani	גאלוואני
Soma	סומא
Schneider	שנאידר
Rabah	ראבח
Endemol	אנדמול
Lapetra	לאפיטרא
Holmes	הולמז
Mihoubi	מיהובי
Mullins	מאלינז
Shinkansen	שינקאנסן
Yartsev	יארטסיב
Goma	גומע
Meghni	מגני
Lawton	לוטון
Barbour	בארבור
Augsburg	אוגסברג
Gnako	גנאקו
Morrow	מורו
Laskarina	לאסקארינא
Cannes	קאן
Kaplinsky	קאפלינסקי
Varnhagen	וארנהאגן
Eames	אימז
Abdullah	עבדאללה
Quashie	קואשי
Hyde	האיד
Arnaut	ארנוט
Breeze	בריז
Penn	פן
Boston	בוסטן
Keane	קין
Karim	קרים
Zarruq	זרוק
Rodney	רודני
Lamyaghri	למיאגרי
Rikdo	ריקדו
Jaime	ג'יימי
Domna	דומנא
Wakamoto	ואקאמוטו
Dragan	דראגאן
Benn	בן
Starbucks	סטארבאקס
Mccracken	מקראקין
Mbamba	מבאמבא
Natascha	נאטאשא
Wasserman	ואסרמאן
Deen	דין
Mateo	מאטיו
Soyer	סויר
Gianluigi	ג'אנלויג'י
Vishneva	וישניבא
Jakub	ג'אקוב
Lenev	לנב
Shriki	שריקי
Whitman	ויטמאן
Kaklamanakis	קאקלאמאנאקיס
Nessim	נסים
Iosif	איוסיף
Massoud	מסעוד
Merkaz	מרכז
Ilham	אילהאם
Bacon	בייקון
Mphela	מפילא
Miron	מירון
Tibbets	טביטס
Wadih	ואדיח
Fatton	פאטון
Naohiro	נאוהירו
Greene	גרין
Valencia	ואלנסיא
Korbut	קורבט
Hosic	הוסיטש
Wadie	ודיע
Logofet	לוגופיט
Salvatore	סאלבאטורי
Nachbar	נאכבאר
Peseiro	פסיירו
Corbusier	קורבוסייה
Maroun	מארון
Lech	לך
Yamadayev	יאמאדאייב
Cech	צ'ק
Emanuele	אמאנואל
Adhan	אדאן
Vadim	ואדים
Zalayeta	זאלאייטא
Biber	ביבר
Ferenc	פירינק
Mohamed	מוחמד
An	אן
Juventud	ג'ובינטוד
Crowley	קראולי
Meshal	משעל
Kirov	קירוב
Kwanzaa	קואנזא
Lucarelli	לוקארילי
Diamantino	דיאמאנטינו
Brady	בריידי
Rivest	ריבסט
Nakamatsu	נאקאמאצו
Jacek	ג'אסיק
Kutaisi	קוטאיסי
Bartlett	בארטלט
Jensen	ג'נסן
Numan	נומאן
Savo	סאבו
Bingu	בינגו
Olafur	אולאפור
Reid	ריד
Veii	ויי
Tunis	טוניס
Niamey	ניאמי
Asuncion	אסונסיון
Lear	ליר
Quim	קוים
Patrik	פאטריק
Michaels	מאיקלז
Marzel	מארזל
Gourcuff	גורקוף
Noboru	נובורו
Klug	קלוג
Shamekh	שאמך
Gillerman	גילרמאן
Sellimi	סלימי
Acrobat	אקרובאט
Nobunaga	נובונאגא
Hilario	הילאריו
Tankian	טאנקיאן
Zagallo	זאגאלו
Auguste	אוגסט
Vassaras	ואסאראס
Sara	סארא
Tara	טארא
Hara	הארא
Hajduk	האידוק
Kachalin	קאצ'אלין
Nozomu	נוזומו
Jabal	ג'בל
Dmitriev	דמיטרייב
Hocine	הוסין
Gallice	גאליסי
Bilal	בילאל
Bara	ברא
Dara	דארה
Bettiol	ביטיול
Serhiy	סרגיי
Shackleton	שאקלטון
Rommel	רומל
Limassol	לימאסול
Kostikos	קוסטיקוס
Milosevic	מילוסיביטש
Norizan	נוריזאן
Mati	מאטי
Boyens	בוינס
Maeterlinck	מאטרלינק
Edwin	אדוין
Dati	דאטי
Amichai	עמיחי
Chaves	שאביס
Bodo	בודו
Brando	בראנדו
Zgharta	זגארטא
Total	טוטאל
Alsiqilli	אלסיקילי
Tijani	טיג'אני
Carrara	קארארא
Josip	ג'וסיפ
Kahveci	קהווג'י
Afghanistan	אפגנסיטאן
Neuville	נוביל
Milt	מילט
Atar	עטאר
Kiichi	קיצ'י
Paintsil	פיינציל
Fernand	פרנאנד
Gautama	גוטאמא
Danilo	דאנילו
Wathiq	ואתיק
Modibo	מודיבו
Bernadotte	ברנאדוט
Diskin	דיסקין
Shiva	שיבא
Sars	סארס
Katongo	קאטונגו
Grinder	גראינדר
Houari	הוארי
Rulfo	רולפו
Grava	גראבא
Chicago	שיקאגו
Eliot	אליוט
Fusi	פוזי
Zidane	זידאן
Sisyphus	סיזיפוס
Dafoe	דאפו
Gonzaga	גונזאגא
Marach	מאראצ'
Hrvoje	הירבוי
Geels	גילז
Cobi	קובי
Frederik	פרידיריק
Jeff	ג'ף
Herbert	הרברט
Shigeru	שיגירו
Nadim	נדים
Hoyte	הויט
Mykolaiv	מיקולאיב
Skerritt	סקיריט
Marisa	מאריסא
Ribisi	ריביסי
Marina	מארינא
Christa	קריסטא
Prado	פראדו
Lochhead	לוקהד
Zabaleta	זאבאליטא
Dockx	דוקס
Jos	ג'וס
Marica	מאריקא
Hideaki	הידיאקי
Steinitz	סטייניץ
Cuenca	קוינקא
Proline	פרולין
Agranat	אגרנט
Yuba	יובא
Rooney	רוני
Hijazi	חיג'אזי
Warraq	וראק
Seinfeld	סיינפילד
Suvrijn	סוברין
Blondeau	בלונדו
Huddlestone	האדלסטון
Dupree	דופרי
Karpinski	קארפינסקי
Jacopo	יאקופו
Vogts	ווגטס
Hayashi	האיאשי
Attenborough	אטנבורו
Dangda	דאנגדא
Eilat	אילת
Baloyi	באלויי
Aatef	עאטף
Irene	אירין
Drenthe	דרינטה
Donizetti	דוניזיטי
Buncol	בונקול
Likud	ליכוד
Mudi	מודי
Myspace	מאיספייס
Hamdan	חמדאן
Vagiz	ואגיז
Dudi	דודי
Tomasz	טומאס
Python	פאיתון
Alassad	אלאסד
Mccartney	מקארטני
Manuele	מאנויל
Cake	קייק
Codina	קודינא
Heracles	היראקליס
Christov	קריסטוב
Turnbull	טרנבול
Tivoli	טיבולי
Scarpa	סקארפא
Sorman	סורמאן
Vermaelen	ורמיילן
Ivo	איבו
Mathieu	מאטיו
Sabato	סאבאטו
Sivori	סיבורי
Hakkinen	האקינן
Sorrento	סורינטו
Koyasu	קויאסו
Denktas	דנקטאס
Evo	איבו
Valentina	באלנטינא
Dudka	דודקא
Revere	ריביר
Asakir	עסאקיר
Magid	מגיד
Magic	מאג'יק
Reem	רים
Bernini	בירניני
Metzudat	מצודת
Marchetto	מארקיטו
Regensburg	ריגנסברג
Gaon	גאון
Hoodia	הודיא
Michiru	מיטשירו
Francescoli	פראנסיסקולי
Gregotti	גריגוטי
Faten	פאטן
Mariana	מאריאנא
Hicham	הישאם
Cannon	קאנון
Enkhbayar	אנכבאיאר
Romer	רומר
Hausmann	האוסמאן
Hughton	היוטון
Animaniacs	אנימאניאקס
Nyerere	נירירי
Grnemeyer	גרנמייר
Nikopolidis	ניקופולידיס
Washington	ואשינגטן
Economist	אקונומיסט
Torbinski	טורבינסקי
Romeo	רומיו
Hedy	הידי
Eiffel	איפל
Bahrani	בחראני
Leroux	לירו
Stirling	סטירלינג
Serginho	סירגינהו
Davids	דייוידז
Kakuro	קאקורו
Narita	נאריטא
Thousand	תוסנד
Rimitti	רימיטי
Klaws	קלוס
Vidic	בידיטש
Theodoric	תיודוריק
Peres	פרס
Hawi	חאוי
Galasek	גאלאסיק
Posey	פוזי
Reyad	ריאד
Togo	טוגו
Perez	פיריז
Fisichella	פיסיקילא
Lukoil	לוקויל
Givat	גבעת
Perec	פרק
Hikmet	חיקמט
Tzur	צור
Libar	ליבאר
Israels	איזרילז
Havilland	האבילאנד
Modiri	מודירי
Hitoshi	היטושי
Busby	באסבי
Loukas	לוקאס
Piot	פיוט
Saab	סעב
Safina	סאפינה
Stech	סטיטש
Serine	סירין
Jianqing	ג'יאנקינג
Uranus	אוראנוס
Hanaoui	חנאוי
Moreau	מורו
Hematocrit	הימאטוקריט
Johann	יוהאן
Xiang	קסיאנג
Mohsen	מוחסן
Boca	בוקא
Villarreal	וילאריאל
Sharansky	שאראנסקי
Yafa	יאפא
Hisham	הישאם
Florentin	פלורנטין
Rafa	רפא
Geri	גירי
Zat	זאט
Protocol	פרוטוקול
Wangari	ואנגארי
Rowan	רואן
Korneyev	קורנייב
Diouf	דיוף
Nafa	נפאע
Sexton	סקסטון
Runstrom	ראנסטרום
Wittgenstein	ויטגינשטאין
Daoud	דאוד
Mazhar	מזהר
Brocchi	ברוקי
Shalom	שלום
Dahlan	דחלאן
Karle	קארל
Tov	טוב
Elmore	אלמור
Collette	קוליט
Birgit	בירגיט
Chiwa	צ'יוא
Levinger	לבינג'ר
Schmidt	שמידט
Gulbenkian	גולבנקיאן
Hampstead	האמפסטיד
Masoud	מסעוד
Dov	דוב
Novin	נובין
Gail	גייל
Staunton	סטונטון
Mauroy	מורוי
Cazorla	קאזורלא
Bellamy	בילאמי
Moeneeb	מוניב
Chiesa	קייזא
Salzman	סאלצמאן
Steinmeier	שטאינמאיר
Burkina	בורקינא
Beckenbauer	בקנבאור
Lipton	ליפטון
Patmos	פאטמוס
Gosling	גוסלינג
Bright	בראיט
Imereti	אימיריטי
Tyrol	טירול
Linus	לאינוס
Ababil	אבאביל
Dunne	דון
Kuznetsova	קוזנטסובא
Dotan	דותן
Lvov	לבוב
Daimyo	דאימיו
Heyse	הייס
Nuri	נורי
Ashcroft	אשקרופט
Lesniak	לסניאק
Buble	בובלה
Bunin	בונין
Jane	ג'יין
Wilder	ואילדר
Tamas	טמאס
Victoria	ויקטוריא
Macdonald	מאקדונאלד
Chivu	צ'יבו
Kristiansand	קריסטיאנסאנד
Adnan	עדנאן
Mazloum	מזלום
Inmarsat	אינמארסאט
Bale	בייל
Brundle	בראנדל
Pamungkas	פאמונגקאס
Ferrell	פירל
Krylov	קרילוב
Hasler	האסלר
Persephone	פירסיפוני
Viggo	ויגו
Ionescu	איוניסקו
Walesa	ואליסא
Ketone	קיטון
Bloom	בלום
Andres	אנדריס
Zimmermann	זימרמאן
Zauri	זאורי
Winstone	וינסטון
Hartnett	הארטניט
Fuste	פוסטי
Spycher	ספאיקר
Tempelhof	טמפלהוף
Takahata	טאקאהאטא
Shakespeare	שקספיר
Millichip	מיליצ'יפ
Hume	היום
Siviglia	סיביליא
Kaiafas	קאיאפאס
Amapa	אמאפא
Weizmann	ויצמן
Campania	קאמפאניא
Halo	האלו
Valera	באלירא
Kalo	קאלו
Baume	בום
Colombier	קולומבייה
Norman	נורמאן
Ziani	זיאני
Tisdale	טיסדייל
Glam	גלאם
Elbert	אלברט
Aristide	אריסטיד
Tolga	טולגא
Minsk	מינסק
Sanguinetti	סאנגויניטי
Clichy	קלישי
Zamora	זאמורא
Wegener	ווגנר
Brent	ברינט
Melissa	מליסיא
Zaha	זהא
Celtics	סלטיקס
Shamlou	שאמלו
Bordet	בורדה
Saha	סאהא
Taha	טאהא
Bresse	בריס
Dumitru	דומיטרו
Kovacevic	קובאטשיביטש
Gardner	גארדנר
Arend	ארינד
Larfaoui	לערפאוי
Aalto	אלטו
Whitney	ויטני
Carlebach	קארליבאך
Frantisek	פראנטיסק
Vltava	ולטאבא
Hernych	הירניטש
Yusef	יוסף
Almajid	אלמג'יד
Monrovia	מונרוביא
Kaji	קאג'י
Darwish	דרויש
Glenn	גלין
Lodetti	לודיטי
Hamas	חמאס
Torsten	טורסטן
Ileana	איליאנא
Yaping	יאפינג
Maalouf	מעלוף
Zandi	זאנדי
Carrero	קארירו
Nashef	נאשף
Moshav	מושב
Vered	ורד
Chaabi	שעבי
Juana	חואנא
Alia	עליא
Batista	באטיסטא
Rampal	ראמפאל
Mazda	מאזדא
Promethium	פרומיתיום
Pettis	פטיס
Stefanescu	סטיפאניסקו
Abel	אבל
Aleman	אלימאן
Kovalyov	קובאליוב
Simic	סימיטש
Szymborska	שימבורסקא
Thaci	תאצ'י
Dany	דאני
Octave	אוקטאב
Mosul	מוסול
Kazuhiko	קאזוהיקו
Yousef	יוסף
Dalida	דאלידא
Leblanc	לבלאנק
Emily	אמילי
Salvadore	סאלבאדור
Yousuf	יוסוף
Tareq	טארק
Louise	לואיז
Yahel	יאהיל
Selkirk	סילקירק
Gorky	גורקי
Gates	גייטס
Seman	סימאן
Semak	סימאק
Pacifico	פאסיפיקו
Tsarev	טסאריב
Tuz	טוז
Masopust	מאסופסט
Neptune	ניפטון
Giovane	ג'יובאני
Zoi	זוי
Satsuki	סאצוקי
Ljubljana	ליובליאנא
Seattle	סיאטל
Satu	סאטו
Grundig	גרונדיג
Keren	קרן
Demirel	דימיריל
Giannis	ג'יאניס
Paneriai	פאניראי
Nuno	נונו
Gordon	גורדון
Tlass	טלאס
Martina	מארטינא
Rosalind	רוזאלינד
Mendes	מינדיס
Vermeer	ורמיר
Lamar	לאמאר
Azad	אזאד
Mccoist	מקויסט
Bouchardeau	בושארדיו
Livorno	ליבורנו
Liston	ליסטון
Saura	סאורא
Aqel	עקל
Pourpirar	פורפיראר
Kabardin	קאבארדין
Sadako	סאדאקו
Borgnine	בורגנין
Samosa	סאמוסא
Andrey	אנדריי
Shiro	שירו
Shiri	שירי
Chaiman	צ'אימאן
Nordtveit	נורדבייט
Zayatte	זאיאטי
Porush	פורוש
Reich	ראיק
Heynckes	הינקס
Nils	נילס
Knuth	קנות
Simone	סימון
Melanie	מילאני
Kamal	קמאל
Palatinate	פאלאטינייט
Cornet	קורנה
Marinca	מארינקא
Zambezi	זאמביזי
Daguerre	דאגר
Ash	אש
Berg	בירג
Venus	וינוס
Arik	אריק
Karamanlis	קאראמנליס
Mugabe	מוגאבי
Winehouse	ואינהאוס
Paqueta	פאקיטא
Forman	פורמאן
Shazar	שזר
Charlton	צ'ארלטון
Dolby	דולבי
Moutinho	מוטינהו
Caneira	קאנירא
Mee	מי
Attia	עטיה
Gilad	גלעאד
Naihoum	נאיהום
Selene	סילין
Gomez	גומיז
Dee	די
Khali	קאלי
Clive	קלאיב
Shahid	שהיד
Saphir	ספיר
Kappei	קאפיי
Meryl	מיריל
Halls	האלז
Meidani	מידאני
Zahra	זהרא
Nereo	ניריו
Tullamore	טולאמור
Besheer	בשיר
Vandendaele	ואנדנדייל
Qatar	קטר
Kubala	קובאלא
Scirea	שיריא
Zong	זונג
Herzberg	הירצבירג
Bergeroo	בירגירו
Shaltut	שלטוט
Manzoni	מאנזוני
Wakatsuki	ואקאטסוקי
Sandy	סאנדי
Narmer	נארמר
Tsunenaga	צונינאגא
Carmen	קארמן
Montolivo	מונטוליבו
Halilovic	חלילוביטש
Victor	ויקטור
Wong	וונג
Konoe	קונויה
Estudiantes	אסטודיאנטיס
Mouynet	מויניט
Aranha	אראנא
Santamaria	סאנטאמאריא
Keegan	קיגאן
Samarkand	סמרקנד
Khashuri	חאשורי
Lecuona	ליקונא
Kathmandu	קאתמנדו
Grella	גרילא
Beardsley	בירדזלי
Basler	באסלר
Benedetto	בינידטו
Volcker	וולקר
Orabi	עוראבי
Luiz	לויז
Randy	ראנדי
Warhol	וארהול
Surjak	סוריאק
Ganzouri	גנזורי
Christofias	קריסטופיאס
Healey	הילי
Fiori	פיורי
Dudu	דודו
Yasuyuki	יאסויוקי
Standfest	סטאנדפיסט
Pattaya	פאטאיא
Morrell	מורל
Turteltaub	טירטלטאוב
Badran	בדראן
Bardeen	בארדין
Salinas	סאלאינס
Bettega	ביטיגא
Sami	סאמי
Tanit	טאניט
Katsina	קאטסינא
Beschastnykh	ביצ'אסטניך
Camps	קאמפס
Mami	מאמי
Accra	אקרא
Volkan	ולקאן
Feyenoord	פיינורד
Phil	פיל
Arkansas	ארקנסו
Kuwashima	קואשימא
Kemal	קמאל
Nosrati	נוסרטי
Copernicus	קופרניקוס
Ratzel	ראטזל
Cornelius	קורניליוס
Mauri	מורי
Patty	פאטי
Magnus	מאגנוס
Chikhaoui	שיכאוי
Lundin	לונדין
Giggs	גיגז
Topal	טופאל
Australopithecus	אוסטראלופיתקס
Georgians	ג'ורג'ינז
Salfit	סלפיט
Braugher	ברויר
Microsoft	מאיקרוסופט
Koyre	קוירי
Giannakopoulos	ג'יאנאקאפולוס
Lermontov	לרמנטוב
Bledel	בלדל
Thailand	טאילאנד
Mamdouh	ממדוח
Sargon	סרגון
Rahman	רחמן
Damas	דאמאס
Cartwright	קארטראיט
Yassin	יאסין
Pozzo	פוצו
Foxx	פוקס
Cayetano	קאיטאנו
Tatsukichi	טאטסוקיצ'י
Saidou	סאידו
Phillimon	פילימון
Mclachlan	מקלאקלאן
Sadegh	סאדק
Tristram	טריסטראם
Vysotsky	ויסוצקי
Chhetri	צ'טרי
Sammer	סאמר
Horikawa	הוריקאוא
Irakli	איראקלי
Mateut	מאטיוט
Clinkenbeard	קלינקינבירד
Gheorghe	גיורגי
Kinney	קיני
Srna	סרנא
Sol	סול
Furlong	פורלונג
Jaurs	ג'אורס
Bg	בג
Jurica	יוריקא
Jol	ג'ול
Kol	קל
Kisnorbo	קיסנורבו
Bacardi	באקארדי
Sterjovski	סטריובסקי
Casarin	קאסארין
Ela	אלה
English	אינגליש
Husserl	הוסרל
Mandi	מאנדי
Shelton	שילטן
Petit	פיטיט
Rush	ראש
Manda	מאנדא
Shin	שין
Sancho	סאנשו
Jonson	ג'ונסון
Salih	סאלח
Sheldon	שילדון
Alvaro	אלבארו
Mirsadeghi	מירסאדקי
Bush	בוש
Hanif	חניף
Violeau	ויולו
Kosygin	קוסיגין
Conor	קונור
Theuriau	טוריו
Theorell	טיורל
Boumnijel	בומניג'ל
Basto	באסטו
Cesare	סיזר
Rossini	רוסיני
Schmitt	שמיט
Friedel	פרידל
Rochus	רושוס
Maxwell	מאקסויל
Samitier	סאמיטייר
Mendonca	מנדונקא
Cardoso	קארדוסו
Ruben	רובן
Xun	שון
Yun	יון
Lithuania	ליתואיניה
Peloponnese	פילופוניז
Daniele	דניאל
Sun	סון
Astrid	אסטריד
Hollein	הוליין
Milos	מילוש
Mcgregor	מקגריגור
Jun	ג'ון
Hammett	האמיט
Gamal	גמאל
Saturday	סאטרדיי
Marc	מארק
Abdoulaye	עבדולאי
Wendell	וינדל
Kyrklund	קירקלונד
Mandanda	מאנדאנדא
Danielle	דניאל
Colin	קולין
Jandl	יאנדל
Milan	מילאן
Klee	קליי
Tourani	טוראני
Chedid	שדיד
Fiston	פיסטון
Ghali	גאלי
Huber	הובר
Maximilian	מאקסימיליאן
Nicklas	ניקלאס
Florent	פלורינט
Puttan	פוטאן
Kundera	קונדירא
Russia	ראשא
Golgi	גולגי
Ackerman	אקרמאן
Czerniatynski	זרניאטנסקי
Kaifeng	קאיפנג
Mesa	מסא
Tegucigalpa	טיגוסיגאלפא
Celsius	סלזיוס
Vivo	ביבו
Jaaskelainen	יאסקילאינן
Barrancos	באראנקוס
Dempsey	דמפסי
Thorst	תורסט
Turkish	טורקיש
Niang	ניאנג
Midler	מידלר
Hirohito	הירוהיטו
Daimler	דיימלר
Lydia	לידיא
Emar	אימאר
Fischer	פישר
Boumediene	בומדין
Roxburgh	רוקסבורג
Arto	ארטו
Walid	וליד
Stasi	סטאזי
Ceulemans	קוילמאנס
Tiznit	טזניט
Rostov	רוסטוב
Shesternyov	שיסטרניוב
Hatta	חטא
Mihajlovic	מיהאילוביטש
Lippmann	ליפמאן
Kahneman	קאהנמאן
Locarno	לוקארנו
Satyagraha	סאטיאגראהא
Kalfat	קאלפאט
Razzano	ראזאנו
Craiova	קראיובא
Masami	מאסאמי
Kira	קירא
Gold	גולד
Mira	מירא
Phelps	פילפס
Yukiya	יוקיא
Galinovic	גאלינוביטש
Carey	קארי
Arsen	ארסן
Arabian	ארייביאן
Paula	פאולא
Dlouhy	דלוהי
Marion	מאריון
Buisson	בויסון
Godwin	גודוין
Voight	בויט
Tusseau	טוסו
Sylvinho	סילביניו
Lusaka	לוסאקא
Paulo	פאולו
Broderick	ברודריק
Maia	מאיא
Nasr	נסר
Gyorgy	גיורגי
Maghreb	מאגרב
Korolenkov	קורולנקוב
Umar	עומר
Vasile	ואסילי
Sanbar	סנבר
Schutz	שוץ
Mitoraj	מיטוראי
Andorra	אנדורא
Ljubisa	ליוביסא
Barzagli	בארזאלי
Ethiopia	אתיופיא
Carson	קארסון
Takeuchi	טאקיוצ'י
Blasi	בלאזי
Hourani	חוראני
Srecko	סריצ'קו
Dupont	דופונט
Senamuang	סינאמואנג
Finnan	פינאן
Blass	בלאס
Matty	מאטי
Naveen	נאבין
Talpiot	תלפיות
Trier	טריר
Quixote	קיוטי
Mbeki	מביקי
Matsumoto	מאטסומוטו
Suree	סורי
Butor	בוטור
Yury	יורי
Matti	מאטי
Gascony	גאסקוני
Major	מייגו'ר
Nahman	נחמן
Paulson	פולסון
Tezuka	טיזוקא
Ignac	איגנץ
Lebanon	לבאנאן
Lemerre	לומיר
Shirokov	שירוקוב
Ericson	אריקסון
Guus	גוס
Lothair	לותייר
Sutton	סוטון
Haeckel	היקל
Simpson	סימפסון
Ravitz	רביץ
Nsibambi	נסיבאמבי
Veyron	ויירון
Ledley	לידלי
Naka	נאקא
Morse	מורס
Collar	קולאר
Stojkovic	סטויקוביטש
Borrelli	בורילי
Lucy	לוסי
Collor	קולור
Leonardo	ליונארדו
Garner	גארנר
Qabbani	קבאני
Kristensen	קריסטנסן
Rajoub	ר'גוב
Deucalion	דוקאליון
Pitts	פיטס
Pele	פלה
Bando	באנדו
Pirlo	פירלו
Rusedski	רוסדיסקי
Nagano	נאגאנו
Miriam	מיריאם
Esteban	אסטבאן
Espoo	אספו
Barkley	בארקלי
Benghazi	בנגאזי
Gustave	גוסטאב
Ismail	אסמאעיל
Dele	דילי
Sandro	סאנדרו
Temmu	טמו
Abrahams	אבראהאמז
Kaebi	קעבי
Bourdieu	בורדיו
Gambon	גאמבון
Lauper	לופר
Chahine	שאהין
Marois	מארוא
Terauchi	טיראוצ'י
Courtois	קורטוא
Okafor	אוקאפור
Grosso	גרוסו
Kouchner	קושנר
Brigitte	בריגיט
Seiichiro	סייצ'ירו
Hannes	האניס
Kidmat	קידמט
Sennett	סיניט
Streep	סטריפ
Mikey	מאיקי
Paltel	פאלטל
Fichman	פישמאן
Metin	מיטן
Pike	פאיק
Morell	מוריל
Piceno	פיסינו
Costacurta	קוסטאקורטא
Packie	פאקי
Rakitic	ראקיטיטש
Ramzy	רמזי
Gaafar	ג'עפר
Moshoeu	מושיו
Ishtar	אשטאר
Janovic	יאנוביטש
Dujkovic	דויקוביטש
Marsden	מארסדן
Panucci	פאנוצ'י
Courtney	קורטני
Hebuterne	אבוטארן
Busch	בוש
Ramzi	רמזי
Brandenburg	בראנדנברג
Iberia	איביריא
Klaipeda	קלאיפידא
Kosovo	קוסובו
Papoulias	פאפוליאס
Malevich	מאליביטש
Seoul	סיאול
Qutb	קוטב
Riou	ריו
Suharto	סוהארטו
Mikheil	מיכאיל
Solodkin	סולודקין
Mondrian	מונדריאן
Catalani	קאטאלאני
Osment	אוסמנט
Tadic	טאדיטש
Kandahar	קנדהאר
Khamtai	חאמטאי
Deschamps	דישאמפ
Fort	פורט
Taipei	טאיפיי
Newtown	ניוטאון
Sadiq	סאדיק
Sadir	סדיר
Muren	מורן
Enron	אנרון
Mamluk	ממלוק
Stanford	סטאנפורד
Adolphe	אדולף
Titta	טיטא
Lindh	לינד
Choukri	שוקרי
Yahalom	יהלום
Patocka	פאטוקא
Brooklyn	ברוקלין
Linda	לינדא
Cockburn	קוקבורן
Farkash	פארקאש
Bammer	באמר
Lezion	לזיון
Patterson	פאטירסון
Wood	ווד
Laheeb	להיב
Chisholm	צ'ישולם
Matias	מאטיאס
Soufiane	סופיאן
Sher	שר
Henning	הינינג
Bettini	ביטיני
Shatili	שאטילי
Smolnikov	סמולניקוב
Marzouq	מרזוק
Trafford	טראפורד
Bosacki	בוסאצקי
Radio	ראדיו
Hantuchova	האנטשובא
Curl	קורל
Hassan	חסן
Carla	קארלא
Cimabue	צ'ימאבו
Cher	שיר
Eboli	אבולי
Carlo	קארלו
Courbis	קורביס
Perusic	פירוסיטש
Pelle	פילי
Machine	מאשין
Threonine	תריונין
Barrymore	בארימור
Lahore	לאהור
Venturi	וינטורי
Hess	הס
Sandoval	סאנדובאל
Carly	קארלי
Binoche	בינוש
Bacau	באקאו
Pat	פאט
Sankara	סאנקארא
Rushmore	רשמור
Wat	ואט
Hat	האט
Junichiro	גוניטשירו
Kaladze	קאלאדזה
Jiri	ג'ירי
Fedor	פידור
Nat	נאט
Miri	מירי
Piatra	פיאטרא
Cat	קט
Bizimungu	ביזימונגו
Shuttleworth	שאטלוורת
Ribbeck	ריביק
Basile	באסיל
Batta	באטא
Kijuro	קיג'ורו
Schwartzmann	שוארצמאן
Peru	פירו
Banach	באנאך
Hadid	חדיד
Heaney	היני
Dix	דיקס
Rizwan	ריזואן
Mulilo	מולילו
Diderik	דידריק
Fisk	פיסק
Zubin	זובין
Mobutu	מובוטו
Alami	עלמי
Pushkin	פושקין
Marcel	מארסל
Chulapa	צ'ולאפא
Yamamoto	יאמאמוטו
Partizan	פארטיזאן
Benigni	בניני
Amman	עמאן
Ammar	עמאר
Branduardi	בראנדוארדי
Cremieux	קרימייה
Shwikar	שויקאר
Tiselius	טיסיליוס
Hanover	האנובר
Higgs	היגז
Theseus	תיסיוס
Demichelis	דימיצ'לאס
Canberra	קאנבירא
Albayrak	אלבאירק
Briand	בריאן
Guesdon	גויסדון
Landsteiner	לאנדשטאינר
Yaghi	יאגי
Dolmatov	דולמאטוב
Ozil	אוזיל
Dmitriyev	דמיטרייב
Witte	ויט
Natanz	נאטאנז
Semih	סמיח
Yunlong	יונלונג
Metgod	מיטגוד
Kahwaji	קהווג'י
Wissem	ויסם
Zuhair	זוהיר
Hausdorff	האוסדורף
Federici	פדריקי
Maldives	מאלדאיבז
Mjallby	מג'אלבי
Nasri	נסרי
Libor	ליבור
Deripaska	דיריפאסקא
Cetin	ג'טין
Syamsul	סיאמסול
Mashrabiya	משרביה
Celan	צלאן
Bruneau	ברוניאו
Clifford	קליפורד
Valern	ואלירון
Sedki	סדקי
Tenco	טינקו
Fae	פיי
Stanton	סטאנטון
