Aadhi	आधी
Aakash	आकाश
Aap	आप
Aayasha	आयशा
Aayee	आई
Abduh	अब्दुस
Aberhart	एबरहर्ट
Abey	अबेय
Abou	अबू
Abri	अब्री
Academy	अकेडमी
Academy	एकेडमी
Accommodation	एकोमडेशन
Acorn	एकोर्न
Adams	एडम्स
Adgaon	अदगाव
Adlabs	एडलेब्स
Agro	एग्रो
Ahlaad	आह्लाद
Air	एअर
Air	एयर
Aisin	एसिन
Ajee	अजी
Ajhai	अझाई
Ajith	अजीथ
Akaram	अकरम
Akele	अकेले
Akhri	आखिरी
Akodia	अकोडिया
Akurdi	अकुर्डी
Alas	अलास
Albany	अल्बानी
Albany	एल्बनी
Alester	एलेस्टर
Alex	एलेक्स
Alipur	अलीपुर
Alkali	अल्कली
Alpesh	अल्पेश
Amanat	अमानत
American	अमेरिकन
Amodini	अमोदिनी
Andha	अंधा
Angel	एंजेल
Anna	एना
Anne	एनी
Antibody	एंटीबॉडी
Aon	एऑन
Apne	अपने
Araafat	अराफात
Aries	एरीज
Aries	एरीयस
Ark	आर्क
Arman	अरमान
Arms	आर्म्स
Arnott	आरनॉट
Arsikere	अरसिकेरी
Art	आर्ट
Arthurton	अर्थर्टन
Ashoka	अशोक
Ashram	आश्रम
Asperen	एस्पेरेन
Astle	एस्टले
Athey	एथे
Ati	अति
Auckland	ऑकलैंड
Audaen	ओडेन
Auliya	औलिया
Austro	ऑस्ट्रो
Aveline	एवलाइन
Awards	अवार्ड
Awards	अवार्ड्स
Awra	अव्रा
Aybak	अयबक
Ayengi	आयेंगी
Baagul	बागुल
Baan	बान
Baat	बात
Bada	बडा
Bada	बाडा
Badamash	बदमाश
Bader	बॅडर
Badho	बढो
Badmashon	बदमशो
Baghdadi	बगदादी
Baharwali	बाहरवाली
Balamani	बालमणि
Baldrige	बैलरिज
Balkham	बाल्कम
Balvant	बलवंत
Bamori	बामोरी
Bandaratilleke	बन्दारातिलेके
Bandopadyay	बंदोपाध्याय
Banshlai	बंशलई
Baori	बौरी
Baraigram	बराइग्राम
Barney	बर्नी
Barsao	बरसाओ
Basere	बसेरे
Batti	बत्ती
Batu	बटु
Bayazid	बयाजिद
Bazar	बाजार
Beacon	बेकन
Been	बीन
Beethoven	बीथोवेन
Begam	बेगम
Begum	बेगम
Behram	बेहराम
Bembridge	बेम्ब्रिज
Bengal	खाडी
Bengal	बंगाल
Bengal	बेंगाल
Benito	बेनिटो
Bensonvale	बेनसोन्व्हले
Berendrecht	बेरनड्रेच्ट
Beta	बेटा
Bete	बेटे
Bey	बे
Bha	बहा
Bhabi	भाभी
Bhakt	भक्त
Bhanjan	भंजन
Bharose	भरोसे
Bharuch	भरूच
Bharuch	भरुच
Bhatnagar	भटनागर
Bhaujai	भौजाई
Bhed	भेद
Bhool	भूल
Bhuvaneswari	भुवनेस्वरी
Bibhor	बिभोर
Bijani	बिजानी
Bikhare	बिखरे
Bikrom	बिक्रोम
Bilhar	बिलहार
Bill	बिल
Bilson	बिलसन
Biochem	बायोकेम
Biraj	बिरज
Bisalwas	बिसलवास
Blackwell	ब्लैकवेल
Blicks	ब्लिक्स
Blignaut	ब्लिगनॉट
Blind	बलाइंड
Bocher	बोचर
Body	बॉडी
Boeta	बोएटा
Boje	बोजे
Boo	बू
Book	बुक
Border	बोर्डर
Bosch	बॉस्च
Bowles	बाउल्स
Bracewell	ब्रेसवेल
Brahman	ब्राह्मण
Brahmanya	ब्राम्हण्य
Breese	ब्रीस
Breton	ब्रेटोन
Brewery	ब्रेवरी
Briant	ब्रायंट
Bromo	ब्रोमो
Brooke	ब्रुक
Brooke	ब्रूक
Bros	ब्रोस
Brothers	ब्रदर
Brothers	ब्रदर्स
Brownlow	ब्राउनलो
Brunel	ब्रुनेल
Buckland	बकलैंड
Bulfin	बुल्फिन
Bureau	ब्यूरो
Burmah	बर्मा
Bush	बुश
Buy	बाय
Byron	बायरोन
Calgary	कैलगरी
Campbell	केम्पबेल
Campbell	कैंपबेल
Campbell	कैम्पबेल
Canadas	कैनेडास
Capone	कॅपोन
Caring	केअरिंग
Carry	कॅरी
Caulfield	कॉलफील्ड
Chadar	चादर
Chakaradhari	चक्रधारी
Champlain	कैम्प्लेन
Changez	चंगेज
Chankanab	चंकनाब
Chapel	चेपल
Charith	चैरिथ
Chartres	कार्टेस
Chartreuse	चार्ट्यूस
Chassis	चेसिस
Chatfield	चैटफील्ड
Chatterjee	चैटर्जी
Chatterji	चटर्जी
Chaudury	चौधरी
Chaylse	चेल्सी
Cheer	चीयर
Chemical	केमिकल
Chemical	केमिकल्स
Chennakesava	चेन्नकेसवा
Chhoo	छू
Chilbila	चिल्बिला
Chipewyan	चिपवेन
Chirstian	क्रिश्चियन
Choice	चोइस
Cholvaram	चोल्वाराम
Choron	चोरो
Chorvad	चोरवड
Chronicle	क्रॉनिकल
Churchill	चर्चिल
Chyulu	च्यूलु
Cidades	सिडाडेस
Cimatario	सिमातारियो
Citadel	सिटाडेल
Coat	कोट
Coca	कोका
Coffee	कॉफी
Cola	कोला
Colour	कलर
Commandante	कमांडेंट
Computers	कंप्यूटर्स
Condecoracion	कॉन्डेकोरिसियन
Condoleeza	कॉन्डोलीज़ा
Consolidated	कंसोलिडेटेड
Coolagh	कुलॅग
Copco	कोप्को
Corazon	कोराजोन
Cosier	कॉसियर
Count	काउंट
Cref	क्रेफ
Cronje	क्रोंज
Crookhorn	क्रुखोर्न
Crossing	क्रॉसिंग
Crown	क्राउन
Culture	कल्चर
Curtly	कर्टली
Cyber	सायबर
Daal	डाल
Daal	दाल
Dabhoi	दभोई
Dabli	दबली
Daegu	डेगु
Daghfal	दगफल
Dahade	दहाडे
Dahesh	दाहेश
Dai	दाई
Dalrymple	डेलरिम्पल
Damdama	दमदमा
Dannie	डैनी
Dapeng	डापेन्ग
Daryl	डेरिल
Daur	दौर
David	डेविड
Davies	डेवीस
Day	डे
Dead	डेड
Decembre	डिसेम्ब्रे
Deewane	दीवाने
Deirdre	डियड्री
Deke	देके
Dekh	देख
Dena	देना
Denzel	डेंजल
Depot	डिपो
Deryck	डेरिक
Des	डेस
Des	देस
Desoto	डेसॉटो
Devdas	देवदास
Dhahir	धहिर
Dhalaibil	धलायबिल
Dhari	धारी
Dhobari	धोबडी
Diamond	डायमंड
Dibosh	दिबोश
Dickman	डिकमेन
Dike	डाइक
Dilhara	दिलहरा
Dilhara	दिलहारा
Dilwale	दिलवाले
Dina	दीना
Dior	डिऑर
Diplomatic	डिप्लोमैटिक
Disabled	डिसऐबल्ड
Disk	डिस्क
Disney	डिज्नी
Dlink	डीलिंक
Dodi	डोडी
Doll	डोल
Dongargarh	डोंगरगड
Donnanview	डोनाह्यू
Dono	दोनो
Doolha	दुल्हा
Drama	ड्रामा
Dravid	द्रविड
Drawing	ड्रॉइंग
Dripping	ड्रिपिंग
Drive	ड्राइव
Drucilla	ड्रूसीला
Dukakis	ड्यूकाकिस
Dulip	दुलीप
Dwarikesh	द्वारकेश
Dymock	डायमॉक
Eddo	एड्डो
Edger	एडगर
Edmonds	एडमंड्स
Egmore	एग्मोर
Egyptian	इजिप्शियन
Einstein	आइंस्टीन
Elbit	एल्बिट
Elder	एल्डर
Elders	एल्डर्स
Ellan	ऐलान
Elmer	एल्मर
Elong	ईलोंग
Emburey	एंब्यूरे
Enterprises	एंटरप्राइजेस
Erhard	इरहार्ड
Eric	एरिक
Ervine	एरवाइन
Erwin	इर्विन
Erzherzog	अर्झ्हेरजोग
Estonian	एस्टोनियन
Estrella	एस्ट्रिला
Etemad	इतेमाद
Eugenia	यूजेनिया
Explor	एक्सप्लोर
Eyed	आइड
Fantasy	फैंटसी
Fargo	फार्गो
Fasteners	फास्टेनर्स
Fazal	फजल
Fazl	फज्ल
Fernado	फर्नेंडो
Ferrero	फिरेरो
Ferro	फेरो
Fond	फॉन्ड
Fredricka	फ्रेड्रिक्का
Frissiras	फ्रिसिरस
Frontier	फ्रंटियर
Gadag	गदग
Gadra	गदरा
Galaxidi	गैलेक्सीडी
Galileo	गैलीलियो
Gallants	गैलंट्स
Gambhiri	गंभीरी
Ganagapur	गनगापुर
Ganegama	गनेगामा
Garam	गरम
Garm	गरम
Garner	गार्नर
Gauss	गॉस
Gautama	गौतम
Gauvin	गॅविन
Geraldene	गेरल्डेन
Gerita	गेरीता
Germanium	जर्मेनियम
Ghanvatkar	घनवटकर
Ghazali	गजली
Ghoda	घोडा
Ghorakhal	गोराखल
Ghule	घुले
Gifford	गिफॉर्ड
Gifford	जिफॉर्ड
Gladys	ग्लेडिस
Glamorgan	ग्लेमॉर्गन
Globe	ग्लोब
Gokhale	गोखले
Gokte	गोकटे
Gombe	गोंबे
Goncourt	गॉनकोर्ट
Gorshkov	गोर्शकॉव
Gossaigaon	गोसाईगाव
Goswami	गोस्वामी
Govindnagar	गोविंदनगर
Graf	ग्रेफ
Gray	ग्रे
Grentech	ग्रेन्टेक
Greville	ग्रेविले
Gross	ग्रॉस
Gudha	गुधा
Gujarat	गुजरात
Gulabi	गुलाबी
Gulf	गल्फ
Gunderippalam	गुन्देरीप्पलम
Gvk	जीवीके
Haamid	हमीद
Hafeez	हफीज
Haley	हॅले
Half	हाफ
Hamamah	हममाह
Hanste	हसते
Hara	हारा
Harsingar	हरसिंगार
Harvey	हर्वे
Harwich	हारविच
Hatao	हटाओ
Hayy	हय
Heeron	हीरो
Hells	हेल्स
Hemmings	हेमिंग्स
Higher	हाईर
Higher	हायर
Hilfiger	हिल्फिजर
Hill	हिल
Hillcrest	हिलक्रेस्ट
Hindustan	हिंदुस्तान
Hindustan	हिन्दुस्तान
Hisaab	हिसाब
Hiyo	हियो
Hogg	हॉग
Holder	होल्डर
Hole	होल
Holiday	हॉलिडे
Homestead	होमस्टेड
Honda	होंडा
Hone	होने
Hoon	हुन
Hoon	हू
Hosanna	हॉसन्ना
Hub	हब
Huddersfield	हडर्सफील्ड
Hugli	हुगली
Hull	हल
Humari	हमारी
Humpage	हम्पेज
Hunaydah	हुनैदाह
Hundred	हंडरेड
Hunt	हंट
Husn	हुस्न
Hydrogenics	हाइड्रोजेनिक्स
Ibadat	इबादत
Icahn	इचॅन
Igglesden	ईगल्सडन
Image	इमेज
Inam	इनाम
Indukaant	इंदुकांत
Ingersoll	इंगरसॉल
Insaf	इंसाफ
Instruction	इंस्ट्रक्शन
Intercontinental	इंटरकॉन्टिनेंटल
International	इंटरनेशनल
Irishmen	इरिशमेन
Isle	इस्ले
Istvan	इस्वॉन
Italiano	इटालियानो
Itawa	इटावा
Iventure	इवेंचर
Jaafaree	जाफरी
Jaani	जानी
Jaani	जाने
Jaarsveld	जार्सवेल्ड
Jacob	जेकब
Jacob	जैकब
Jahrousse	जहरौस
Jaise	जैसे
Jaitu	जैतु
Jalti	जलती
Jamai	जमाई
Jamda	जमदा
Janasadharan	जनसाधारण
Janjgir	जांजगीर
Javagal	जवगल
Jayanagar	जयानगर
Jayantha	जयंथा
Jayaprakashdaran	जयप्रकाशदरन
Jecy	जेसी
Jeeo	जियो
Jeeta	जीता
Jet	जेट
Jewish	ज्युइश
Jewish	जेवीश
Jhuk	झुक
Jhukenge	झुकेंगे
Jhukta	झुकता
Jilani	जिलानी
Jim	जिम
Jin	जिन
Jo	जॉ
Jo	जो
Jodhpuri	जोधपुरी
Johan	जोहन
Johan	जोहान
Judge	जज
Jwar	ज्वार
Jyotiba	ज्योतीबा
Jyotirlinga	ज्योतिर्लिंग
Kaala	काला
Kaamil	कामिल
Kaashi	काशी
Kab	कब
Kabira	कबीरा
Kajaria	कजरिया
Kalpage	कल्पेज
Kambli	कांबली
Kanaklata	कनकलता
Kandamby	कंडेम्बी
Kandaswamy	कंदस्वामी
Kandh	कंध
Kanengara	कनेनगरा
Kaneria	केनेरिया
Kanhaiya	कन्हैया
Kante	काटे
Kanya	कन्या
Karamah	करमाह
Karanjwan	करंजवान
Karega	करेगा
Karl	कार्ल
Karoonga	करूंगा
Karwa	करवा
Kasturi	कस्तुरी
Kasturi	कस्तूरी
Katilon	कातिलो
Katse	कट्से
Kawachi	कवाची
Kazim	काज़िम
Keats	कीट्स
Kenedy	कॅनेडी
Kennedy	केनेडी
Kennedy	कैनेडी
Kenosha	केनोशा
Kerr	केर
Kettle	केटल
Ketu	केतू
Khaled	खालिद
Khana	खाना
Khayriyah	खैरियाह
Khayyam	खय्यम
Khelte	खेलते
Khoda	खोदा
Khooni	खूनी
Khufia	खुफिया
Kijkuit	किजकूट
Killarney	किल्लारने
Kirmani	किरमानी
Kis	किस
Kise	किसे
Kisi	किसी
Kissa	किस्सा
Kitne	कितने
Klusener	क्लूजनर
Kol	कोल
Kon	कोण
Korene	कोरेन
Kosan	कोसान
Koto	कोटो
Krebs	क्रेब्स
Kris	क्रिस
Kulasekara	कुलसेकरा
Kutte	कुत्ते
Kyonji	क्योंजी
Lac	लैक
Lajwati	लाजवती
Lakshmipathy	लक्ष्मीपति
Lal	लाल
Land	लैंड
Lanen	लैनन
Las	लास
Lasker	लास्कर
Layegi	लाएगी
Lehmann	लेहमन
Lei	लेई
Lei	लेय
Lenge	लेंगे
Letters	लेटर्स
Lever	लीवर
Leyland	लेलैंड
Light	लाइट
Lindy	लिंडी
Lisa	लिसा
Lobachevsky	लोबाचेवस्की
Loha	लोहा
Lok	लोक
Loydchiles	लॉयडचिलेज
Lucky	लकी
Luitpold	ल्यूटपोल्ड
Luther	लुथर
Luther	ल्यूथर
Lynn	लिन
Lytton	लायटन
Maahir	माहिर
Maange	मांगे
Maar	मार
Macewen	मैकवेन
Mackay	मैके
Mad	मेड
Madari	मदारी
Madine	मदीने
Magna	मैग्ना
Mah	महाराष्ट्र
Mahajabeen	महजबी
Mahapatra	महापात्र
Mahommed	मोहम्मद
Mail	मेल
Mal	मल
Malka	मलका
Malka	माल्का
Maluku	मलुकू
Mamta	ममता
Manikpur	मानिकपुर
Manjural	मंजुरल
Mannar	मन्नार
Mansoor	मंसूर
Marcantonio	मार्केंटोनियो
Marchais	मार्केस
Marie	मेरी
Marjina	मर्जीना
Marudhanadhi	मरुधानधी
Masjid	मस्जिद
Mason	मैसन
Matav	मातव
Mathew	मैथ्यू
Matt	मैट
Mattis	मैटिस
Maunsell	मॉन्सेल
Mawenge	मवेंजी
Mawlana	मौलाना
Mcclary	मैकक्लैरी
Meda	मेदा
Meghdoot	मेघदूत
Meher	मेहर
Mehrab	मेहराब
Mei	मे
Melleha	मेलेहा
Memorial	मेमोरियल
Memorial	मेमोरीयल
Menara	मेनरा
Menara	मेनारा
Mengkuang	मेंगक्वांग
Mera	मेरा
Mere	मेरे
Merit	मेरिट
Merrill	मेरिल
Metal	मेटल
Meth	मेथ
Methuselah	मेथुसेलाह
Mexican	मैक्सिकन
Meyrick	मेरिक
Mhale	म्हाले
Michener	मिकॅनर
Micholi	मिचौली
Middleton	मिडल्टन
Milai	मिलाई
Minto	मिंटो
Mitcham	मिटचॅम
Mitenge	मिटेंगे
Mitsubishi	मित्सुबिशी
Moinuddin	मोइनुद्दीन
Monsanto	मोनसेंटो
Montshire	मॉन्टशायर
Morosini	मोरोसिनी
Morro	मॉरो
Moultrie	मॉल्ट्री
Mouth	माउंट
Mozart	मोजार्ट
Mrinali	मृणाली
Mujeeb	मुजीब
Mulhouse	मुल्हाउस
Multi	मल्टी
Muneem	मुनीम
Munsif	मुंसिफ
Muralitharan	मुरलीथरन
Murdoch	मर्दोच
Mushfiqur	मुश्फिकर
Mutahharah	मुताहराह
My	माय
Naami	नामी
Naate	नाते
Nagamootoo	नगामूटू
Nahin	नहीं
Nakhimov	नखीमोव
Nansen	नानसेन
Nascopie	नैस्कोपी
Nasheen	नशीन
Nawaz	नवाज
Naya	नया
Nazar	नजर
Neeli	नीली
Neera	नीरा
Netravati	नेत्रवती
Night	नाइट
Nightingale	नाइटेंगल
Nikita	निकिता
Nimrod	नीमरोड
Nirdoshi	निर्दोषी
Nishchay	निश्चय
Nolte	नोल्टे
Noord	नूर्ड
Northern	नॉर्थन
Northumbria	नार्थउंब्रिया
Nottingham	नॉटिंगहॅम
Nottingham	नॉटिंघम
Novamerican	नोवामेरिकन
Oldonyo	ऑल्डोन्यो
Oonch	उंच
Or	ऑर
Orly	ऑरली
Ormula	ऑर्म्युला
Osamu	ओसामु
Overland	ओवरलैंड
Paandu	पांडु
Painter	पेंटर
Palanca	पेलन्का
Palung	पालुंग
Panama	पनामा
Pantanal	पेंटानल
Papps	पैप्स
Par	पर
Par	पार
Parcel	पार्सेल
Parineeta	परिणिता
Parkar	पारकर
Parks	पार्क्स
Parthiv	पार्थिव
Parvat	पर्वत
Pascoal	पास्कोल
Pasina	पसीना
Pasqual	पासक्वेल
Patnee	पत्नी
Patton	पॅटन
Pauls	पॉल्स
Pavarotti	पावरोटी
Paying	पेइंग
Payod	पयोद
Peach	पीच
Pearsall	पिअरसैल
Pearson	पीयरसन
Pentamedia	पेंटामीडिया
Peoples	पीपल्स
Person	पर्सन
Peters	पीटर्स
Peterson	पीटरसन
Philo	फिलो
Phoolvati	फूलवती
Photo	फोटो
Photography	फोटोग्राफी
Pick	पिक
Picnic	पिकनिक
Piet	पीट
Place	प्लेस
Plate	प्लेट
Pollock	पोलॉक
Polydex	पॉलीडेक्स
Pontiacs	पॉन्टीएक्स
Pontisse	पॉन्टिस
Poori	पुरी
Pope	पोप
Portela	पोर्टेला
Poste	पोस्ट
Prabhati	प्रभाती
Prachur	प्रचुर
Pramodya	प्रमोद्या
Pregl	प्रेगल
Premio	प्रेमियो
Presernova	प्रीसरनोवा
Press	प्रेस
Priest	प्रीस्ट
Print	प्रिंट
Professional	प्रोफेश्नल
Profiles	प्रोफाइल्स
Provincien	प्रोविंसियन
Pruth	प्रुथ
Publix	पब्लिक्स
Pucca	पक्का
Pukarega	पुकारेगा
Punja	पंजा
Purab	पूरब
Purani	पुरानी
Puroskar	पुरस्कार
Purvoday	पूर्वोदय
Purza	पुर्जा
Pyare	प्यारे
Qin	किन
Quad	क्वाड
Quality	क्वालिटी
Quanoon	कैनून
Quarban	कुर्बान
Quila	क्यूला
Rada	राडा
Ragoonath	रगूनाथ
Rahmah	रहमाह
Raho	रहो
Rahu	राहु
Rain	रेन
Raina	रायना
Rajesh	राजेश
Rajhara	राजहारा
Rakhra	राखरा
Ramco	राम्को
Ramdin	रामदिन
Ranchi	रांची
Rangeeli	रंगीली
Rangeen	रंगीन
Rangile	रंगीले
Raqibul	रकीबुल
Rashk	रश्क
Rastriya	राष्ट्रीय
Reddys	रेड्डी
Refin	रेफ़िन
Rennie	रेनी
Research	रिसर्च
Right	राइट
Rim	रिम
Ripper	रिपर
Ritchie	रित्ची
Robinhood	रॉबिनहुड
Ronduit	रॉनड्यूट
Roopaa	रूपा
Rootha	रूठा
Ruka	रुका
Rush	रश
Ruth	रूथ
Ruzyne	रूजिन
Ryan	रियान
Ryanair	र्‍यानायर
Ryder	रायडर
S	एस
Saab	साब
Sachai	सच्चाई
Sadashiv	सदाशिव
Sadeem	सदीम
Sadhana	साधना
Sadra	सदरा
Safiyyah	सैफियाह
Saful	सैफुल
Said	सईद
Saiful	सैफुल
Saigal	सैगल
Sainte	सेंट
Saleh	सालेह
Sama	समा
Sammy	सैमी
Sammy	सैम्मी
Sanawbar	सनव्बर
Sanitary	सेनिटरी
Sanket	संकेत
Sap	सैप
Sapera	सपेरा
Sariyah	सारियाह
Sarovar	सरोवर
Satta	सट्टा
Satta	सत्ता
Sattaar	सत्तार
Satte	सत्ते
Savu	सावू
Sawar	सवर
Saymukta	सयमुक्ता
Schuyler	स्यूलर
Scissor	सीजर
Scorpio	स्कॉर्पियो
Scottish	स्कॉटिश
Sebastien	सेबेस्टियन
Seblat	सिब्लाट
Secunderabad	सिकंदराबाद
Seedha	सीधा
Seekh	सीख
Sei	सेइ
Sei	सेय
Seiki	सीकी
Seinfeld	सेनफील्ड
Selleck	सीलॅक
Senior	सीनियर
Serjeant	सर्जेंट
Seth	सेठ
Shaanxi	शांक्सी
Shahdara	शाहदरा
Shakespeare	शेक्सपियर
Sham	शाम
Shamshera	शमशेरा
Shanda	शांदा
Shani	शनि
Shatrujay	शत्रुजय
Shaukat	शौकत
Shaul	शॉल
Sheehy	शीहे
Sheetla	शीतला
Sheikh	शेख
Shek	शेक
Sheridan	शेरिडन
Sherwin	शर्विन
Shillingford	शिलिंगफोर्ड
Shivaji	शिवाजी
Shivam	शिवम
Shokh	शोख
Shravanti	श्रवंती
Shrawan	श्रवण
Shubelik	शुबेलिक
Shukla	शुक्ला
Shun	शून
Siad	सिआद
Sidath	सिदाथ
Siddiq	सिद्दीक
Sigourney	सिर्गोनी
Sikkey	सिक्के
Sills	सिल्स
Silverwood	सिल्वरवुड
Sitaphalmandi	सीताफलमंडी
Sky	स्काय
Small	स्मॉल
Solomon	सोलोमन
Solution	सॉल्यूशन
Somerset	सोमरसेट
Sonia	सोनिया
Soolagiri	सूलागिरी
Sosa	सोसा
Soufli	सौफ्ली
Soya	सोया
Special	स्पेशल
Spielberg	स्पीलबर्ग
Spinning	स्पिनिंग
Spion	स्पायन
Sponge	स्पॉन्ज
Sriram	श्रीराम
Stanovoi	स्टानोवोई
States	स्टेट्स
Steele	स्टील
Steels	स्टील्स
Stenka	स्टेंका
Stephens	स्टीफन्स
Steurgat	स्टेउर्गेट
Strawberry	स्ट्रॉबेरी
Strydom	स्ट्रायडम
Sturt	स्टर्ट
Styris	स्टायरिस
Su	सू
Subramanyam	सुब्रमण्यम
Sucre	सुक्रे
Sudirman	सुदिर्मन
Suhaga	सुहागा
Suhaila	सुहैला
Suji	सूजी
Sulagte	सुलगते
Sumerpur	सुमेरपुर
Sundaram	सुंदरम
Super	सुपर
Suphapong	सुफापोंग
Susana	सुसाना
Swann	स्वान
Swinburne	स्विनबर्न
Synchronised	सिंक्रोनाइज्ड
Tabish	तबिश
Tahliana	ताह्लीआना
Tailor	टेलर
Taipei	तायपेई
Tanda	टांडा
Tandy	टेंडी
Tansco	टैंस्को
Tareekh	तारीख
Tavare	तवारे
Tavern	टैवर्न
Tawanda	टवांडा
Teeside	टीसाइड
Telecom	टेलीकॉम
Telegraph	टेलीग्राफ
Terrible	टॅरीबल
Tessica	टेसिका
Tezuka	टेजुका
Thanda	ठंडा
The	द
The	दी
Theatre	थिएटर
Theatre	थेटर
Thelston	थेलस्टन
Thermal	थर्मल
Thief	थीफ
Thilan	थिलन
Thilina	थिलिना
Thorn	थॉर्न
Throgs	थ्रॉग्ज
Thug	ठग
Ticket	तिकीट
Tidings	टिडिंग्स
Tiger	टायगर
Tiltman	टिल्टमैन
Time	टाइम
Toluca	तोलुका
Tomlin	टॉमलिन
Torrent	टॉरेंट
Trading	ट्रेडिंग
Trikaal	त्रिकाल
Trudeau	ट्रुडेऊ
Tsavo	त्सावो
Tuffey	टफी
Tumhara	तुम्हारा
Turco	तुर्को
Ueberroth	युबेरोथ
Ujesh	उजेश
Ulster	अलस्टर
United	यूनाइटेड
Up	अप
Usha	उषा
Uthata	उठता
Utseya	उत्सेया
Vallar	वल्लार
Vaulting	वॉल्टिंग
Veinticinco	वेंटिसिन्को
Velcro	वेल्क्रो
Vembakottai	वेम्बकोत्ताई
Venetian	वेनेटियन
Venkatapathy	वेंकटपती
Verizon	वरीझोन
Vesuvius	वेसुवियस
Vibhushan	विभूषण
Vikalp	विकल्प
Vilenica	विलेनिका
Vivah	विवाह
Vrashabh	वृषभ
Vrellis	व्रेलिस
Wahidul	वहीदुल
Wal	वाल
Wala	वाला
Wallington	वैलिंगटन
Wanda	वान्डा
Wasim	वसीम
Wax	वैक्स
Whiting	व्हायटिंग
Whitman	व्हिटमॅन
Whittall	व्हिट्टल
Whoop	व्हूप
Wijesuriya	विजेसूरिया
Williamson	विलियमसन
Williamson	विल्यमसन
Wishart	विशार्ट
Wisneski	विसनेस्की
With	विथ
Woh	वोह
Wolfman	वॉल्फमैन
Woolley	वूले
Wüttemberg	यूटमबर्ग
Yadon	यादो
Yashodhar	यशोधर
Yogeendr	योगींद्र
Zabbar	जब्बार
Zaheer	जहीर
Zellweger	जेलीवॅगर
Zeppelin	जेपलिन
Zindagi	जिंदगी
Zion	जिऑन
